"There ought not to be anything in the whole universe that man can't poke his nose into - that's the way we're built and I assume that there's some reason for that." 

     - Robert Heinlein
Rover's Day Out
An Interactive Fiction by Jack Welch and Ben Collins-Sussman
Release 12 / Serial number 100101 / Inform 7 build 5Z71 (I6/v6.31 lib 6/12N) SD
Type "help" for instructions, credits, and license or just blaze on impetuously.

Janet: David, are you hooked in?
David: Ready to go. Is this the final version of the ACU,
       or another beta?
Janet: A program is never finished, but I think we're ready
       to go.
David: I hope so, Earth could launch any day now.
Janet: Run program.

               *    *    *

Rover's Day Out
An Interactive Simulation by Janet Xiang
Release beta 732 / Serial number 23920401 / Inform 10.6 build Mu-013 (I6/v.7.1 lib 7/18N)

Rover draws pensively on his stubby cigar, the tip glowing red below his dealer's hat. He paws nonchalantly at the scotch and water he has been nursing for the last half hour. Despite the tower of chips in front of him, he's either in trouble now, or trying to play the rest of the table for suckers. His tail is no longer wagging, though, and you suspect that the scotch may be getting the better of him. He can't mass more than about 30 kilos, and he's been putting them away tonight. You push all in, figuring that even if you lose it all, at least you'll get some sleep before you need to get back to the MARSpace. Elva the cleaning lady folds, as does Isaac Asimov and that boy that you kissed in fourth grade. Wait...don't go....where is everyone going?

David: You have some weird dreams.
Janet: You can't hold me responsible for the subconscious
       ramblings of the ACU.

<beep> <beep> <beep>

>look
Alarm clock. Next to bed. Make it stop.

<beep> <beep> <beep>

>x clock
Alarm clock. That annoying alarm clock. The alarm clock is beeping.

<beep> <beep> <beep>

Rover tip-taps loudly across the living room floor.

>x me
Laying down. Wearing pajamas. That's all the description you can handle at this time in the morning.

<beep> <beep> <beep>

From somewhere in the cottage, Rover sneezes loudly to let you know that he's annoyed by the alarm clock.

>x pajamas
It feels like you're wearing a flight suit like the one that pilots wear. On the flight suit, you can feel the more or less round MARSpace insignia, and some embroidered lettering.

<beep> <beep> <beep>

>x insignia
Darkness is great for sleeping, not so good for looking at stuff.

<beep> <beep> <beep>

>x lettering
A sliver of sunlight only goes so far; you can't see that well in the dim light.

<beep> <beep> <beep>

>x sunlight
A single shaft of daylight slices like a laser through the living room. Although dramatic, it does not provide very effective illumination.

<beep> <beep> <beep>

>x living room
Must wake up. Eyes blurry.

<beep> <beep> <beep>

>x eyes
With the drapes closed, you can't see very well.

<beep> <beep> <beep>

>x drapes
The heavy brown drapes are closed. The room is dark.

<beep> <beep> <beep>

>x room
Morning difficult. Alarm on. Turn off alarm.

<beep> <beep> <beep>

>x alarm
It's a cheap, white plastic alarm clock with fading green LEDs that read 5:40 am.  A large button juts out of the top.

David:  Why is it so interested in the clock?
Janet:  Not sure.

<beep> <beep> <beep>

>x button
Mounted almost flush with the top of the clock, you can barely make out the dimly illuminated word "snoo".

David: You could use a new alarm clock.
Janet: You could increase my salary.

<beep> <beep> <beep>

>press button
With as much coordination as you can muster in the morning, you brush your fingers over the snooze button.

The alarm clock rolls into a ball, and flies the length of the vehicle construction facility, chased by an eager, slobbering dalmation. In the Martian gravity, Rover bounds three meters into the air and sails over the heads of an annoyed crew in cleanroom suits working frantically on the main fusion rocket heavy-helium regulator. The mission director, David Venkatachalam, grimaces, but your mother offers you a comforting cup of tea.

David: The ACU certainly has that dog on its mind.
Janet: Well, I do think about Rover a lot. Besides, the Rover is central to the mission, so a lot of the code is dedicated to the Rover.
David: I don't really make that expression do I? I looked pouty.
Janet: All the time, but I like the word "petulant" better than "pouty".
David: I'll stick with pouty.

<beep> <beep> <beep>

>press button
You press the snooze button.

A pudgy puppy hastily rounds a corner, sliding awkwardly on the polished dormitory floor. Behind it, there are flashes of light, and a rolling cloud, a mixture of smoke and Martian atmosphere. As the above-ground structures are ripped apart and lose pressure, the shivering ball of white fur leaps into your arms, burying its snout in the fold of your elbow. The Earth missiles continue to pound the university, but cannot penetrate to this depth. Huddled under a sturdy desk, you pet the frightened dog and hug it tight.

David: Do you always hit the snooze button so many times?
Janet: Yeah. The clock has been broken for years -- I can't reset the alarm time. It always goes off at 05:30, but I don't have to be at the spaceport until 08:30. Luckily, this serves a useful purpose in the simulation. Minimal resources are expended on each wake cycle, but if there were a problem during the approach, the ACU would elevate to full op status rapidly.

<beep> <beep> <beep>

>press button
Your fingers drum reflexively against the snooze button.

Just as your fingers make contact with the alarm clock, your excited dog deftly bats it off the cushion with his tail. The clock tumbles off the side of futon and thuds smartly as it hits the floor, ending the beeping. Rover looks puzzled that the noise has stopped.

Realizing that without the alarm clock you would probably sleep through the entire day, you reluctantly get out of bed.

David: Thank you. I can only take so many dream sequences.
Janet: No problem. So, at this point, the Valkyrie would be at the edge of the probe's stellar system, and ready to switch over from Casimir to condensate drive and begin the approach.

As you get out of bed, you notice that your left arm tickles a bit -- must have been the way you were sleeping.

>look
Living Room
Where the heavy drapes meet, a sliver of sunlight shines into the otherwise dark living room. A framed picture hangs on the living room wall in the small area illuminated by the shaft of light.

>x picture
A picture of the Starship Valkyrie, still under construction in drydock. There is small brass nameplate below the picture.

>x left arm
It's too dark to see much.

>x drapes
The heavy brown drapes are closed. The room is dark.

>x nameplate
A brass nameplate bearing a short inscription. The nameplate is attached to the bottom of the picture.

>read inscription
It says, "Good luck at MARSpace! - Tomasz"

Tomasz's valediction makes you remember happier times...

(remembering the photo)

Your late fianc gave you the photo when you began working on the Valkyrie Project as a graduate student -- a happier time before the Independence War with Earth, and the attacks on Mars by Earth's Myomita Corporation. Back then, Valkyrie's experimental Casimir Drive was an exciting technological adventure, rather than a military priority. Now the Valkyrie is Mars' only chance to recover data from a recently discovered space probe marrooned in deep space. For whatever reason, MARSpace feels that probe could hold information which could finally give Mars the upperhand in its competition with Earth.

David: Why did we lose audio?
Janet: I've muted the memories -- they are, after all, a bit personal. Besides, it's just back story for this mission.
David: Fine, we'll skip the boring parts.

It feels like something is tickling your left arm.

>x left arm
It's too dark to see much.

You feel wispy, tingling itch beginning on your left arm.

>open drapes
You push aside the drapes.

Living Room
You are in the living room of a small cottage. Piped-in sunlight pours in through the room's single window. The principal furnishing is a king-size purple futon which takes up almost all the floor space. From the living room you can see the entrance to the kitchen and bathroom. The cottage's front door is closed.

You can see an alarm clock and Rover here.

>x futon
Your futon is huge, and oh so comfy. The wooden frame supports a king-size mattress that is pulled out to form a bed.

>x frame
A wooden frame designed to some how fold up into a third of the space that it normally occupies when the bed is pulled out. A true feat of engineering and geometry.

>sit on futon
You get onto the purple futon.

>look
Living Room (on the purple futon)
You are in the living room of a small cottage. Piped-in sunlight pours in through the room's single window. The principal furnishing is a king-size purple futon which takes up almost all the floor space. From the living room you can see the entrance to the kitchen and bathroom. The cottage's front door is closed.

You can see an alarm clock and Rover here.

>stand
You get off the purple futon.

>x drapes
The heavy brown drapes are open. Light pours in.

>close drapes
It would be too dark to move around if you close the drapes and you'd risk falling back to sleep. You reconsider and leave the drapes open.

>x widow
You can't see any such thing.

>o window
The window is triple-paned pressure glass, mounted flush with the wall.  Through the window you can see an array of skylights, a park, some grass, and some trees.

The itching is getting worse, your left arm is beginnng to bother you.

Rover looks at the alarm clock.

>open window
The windows are triple-paned both as a matter of thermal efficiency and some insurance against catastrophic decompression of the dome, however unlikely that might be these days.

It feels like you might have a bug bite on your left arm.

>x skylights
Early morning sunlight piped from the surface of the planet shines brightly on the well-manicured lawn of the park.

>x park
Lincoln Park is the largest park dome in Cydonia. Later today, you'd expect it to be full of people playing frisbee, picnicking and otherwise enjoying the great outdoors.

>x trees
A line of tall, dark green trees stands at the far edge of the park.

>look
Living Room
You are in the living room of a small cottage. Piped-in sunlight pours in through the room's single window. The principal furnishing is a king-size purple futon which takes up almost all the floor space. From the living room you can see the entrance to the kitchen and bathroom. The cottage's front door is closed.

You can see an alarm clock and Rover here.

Rover is watching you.

>x rover
(Rover)
He's a gentle, obedient dalmation.

Rover circles the drapes.

You left arm is rather itchy.

>x door
(the front door)
The front door of the cottage is closed.

Feels like you've got a mosquito bite on your left arm.

>open door
(the front door)
If you open the front door, Rover will get all excited and expect to go walkies. Better get your morning routine out of the way first.

What did you ever do to your left arm to make it itch so much? It's quite unpleasant.

Rover bounds up onto the futon and begins to get comfortable, rolling his muzzle back and forth on the mattress. Abruptly, his head pokes up and he realizes that you are watching him. Recognizing the awkwardness of being caught on the forbidden futon, Rover slinks down behind it and slowly emerges. He looks over his own shoulder at the futon as if to say "I wonder who that dog was on the futon".

>x arm
Which do you mean, the left arm, or the right arm?

>left
That's odd, your arm itches like the dickens (yes, even in the throws of perturbing progressive pruritis, the word that comes to mind is "dickens". You don't know why. It doesn't really matter. What matters is that your arm is itchy.  Really itchy. Dickens, indeed. Anyhow, even though your arm itches like the dickens, it looks quite normal. 

That left arm of yours is really itching a lot.

>x arm
Which do you mean, the left arm, or the right arm?

>left
You'd imagine your arm would be swollen and red, and all sausage-like, but it looks normal despite the itching.

>scratch left arm
Ooooo. Ahhhh...slowly, the itchiness subsides. That feels so good.

David: Is the static charge neutralization part of the script?
Janet: No, that's the point of the ACU -- it isn't a set script. As we throw malfunctions at it in these simulations, the ACU responds appropriately. We can't, for instance, know that Valkyrie will accumulate a static charge in a particular area, so the ACU has to be flexible enough to react to unpredictable events.
David: Like you would.
Janet: Subject to the resolution of the synaptic scan, yes.

>rub left arm
You achieve nothing by this.

>look
Living Room
You are in the living room of a small cottage. Piped-in sunlight pours in through the room's single window. The principal furnishing is a king-size purple futon which takes up almost all the floor space. From the living room you can see the entrance to the kitchen and bathroom. The cottage's front door is closed.

You can see an alarm clock and Rover here.

Rover rubs his nose.

>go kitchen
You can't really move around much because of the futon. It takes up a lot of room.

David: Isn't that a tad inconvenient?
Janet: Yeah, but it kind of made sense when I got it.

>push futon
With a little effort, the futon folds up, snug against the wall, leaving more room to walk around the cramped cottage.

Rover rests his front paws on the window and stares out at the Park.

>n
Compass directions? On Mars? The magnetic field here is too weak.

>e
Compass directions? On Mars? The magnetic field here is too weak.

Rover stares at his own paws, entirely entranced.

>look
Living Room
You are in the living room of a small cottage. Piped-in sunlight pours in through the room's single window. The principal furnishing is a king-size purple futon which takes up almost all the floor space. From the living room you can see the entrance to the kitchen and bathroom. The cottage's front door is closed.

You can see an alarm clock and Rover here.

>go to kitchen
Kitchen
The kitchen is small but functional, with a space-saver refrigerator and a glass-top electric range. There is a drawer under the range. On the opposite wall there is a sink and under it, a storage cabinet.

You can see a water bowl (empty) and a food bowl (empty) here.

From the direction of the living room, you hear Rover walking in your direction.

>x refrigerator
The small refrigerator dates back to the international era, but is still in good working order, if somewhat small by today's standards. The glossy, white enameled unit has a single compartment. A strip of yellow magpaper is attached to the refrigerator door.

David: Isn't a "to-do" list a little heavy handed?
Janet: Sure, but stuff has to happen in a certain order, and it's just more efficient this way.
David: I think it would be better if it were less linear and more rule-based.
Janet: Okay, mister critic, then you write the code. If we want to recover that probe before Earth gets to it, we are on a very tight development and testing schedule.

>get paper
If you moved the "to do" list, you'd need another note to remind you where you put the list. Better to just leave it there.

>get door
That's hardly portable.

From the direction of the living room, you hear Rover entertaining himself.

>look
Kitchen
The kitchen is small but functional, with a space-saver refrigerator and a glass-top electric range. There is a drawer under the range. On the opposite wall there is a sink and under it, a storage cabinet.

You can see a water bowl (empty) and a food bowl (empty) here.

>open refrigerator
As the fridge creaks open on its ancient hinges, Rover slips into the kitchen. He pokes his nose in the fridge and sniffs around, although he knows full well that stuff in the fridge is for people only and that he'd be in a heap of trouble if he got too curious in there.

Rover sighs audibly and frowns at his food bowl. He looks at you with imploring puppy dog eyes and then back again at his empty food bowl.

>x hinges
Rusty hinges that have never worked smoothly.

Rover contemplates the profound emptiness of the food bowl. He paws pathetically at the food bowl, and the hollow, tin ring of the pitiful bowl echoes through the kitchen.

>get food bowl
Taken.

Rover tingles with anticipation as he stares at the bowl you're carrying.

He eyes the empty water bowl thirstily.

>give food bowl to rover
(Rover)
Rover's stomach growls when you lay down the empty bowl. He looks at you pathetically.

>scratch rover
You rub Rover's chest and his back leg fiddles.

Rover notices the lack of food in his soi-disant food bowl. He looks at the food bowl. He looks at you. He looks at the food bowl. He looks at you.

>rub rover
Rover expresses his gratitiude with some lip smacking sounds.

Rover eyes the empty water bowl thirstily.

I beg your pardon?

>x room
Kitchen
The kitchen is small but functional, with a space-saver refrigerator and a glass-top electric range. The fridge door is not completely closed. There is a drawer under the range. On the opposite wall there is a sink and under it, a storage cabinet.

You can see a food bowl (empty), Rover, and a water bowl (empty) here.

Rover narrows his eyes critically, noting the lack of food in his food bowl. His stomach rumbles with hunger.

He eyes the empty water bowl thirstily.

>x her
I'm not sure what "her" refers to.

>x here
You can't see any such thing.

>x living room
From here, it's hard to see much of the living room at all.

Rover contemplates the profound emptiness of the food bowl. He looks at you with imploring puppy dog eyes and then back again at his empty food bowl.

>x bathroom
You can't see any such thing.

>look
Kitchen
The kitchen is small but functional, with a space-saver refrigerator and a glass-top electric range. The fridge door is not completely closed. There is a drawer under the range. On the opposite wall there is a sink and under it, a storage cabinet.

You can see a food bowl (empty), Rover, and a water bowl (empty) here.

Rover eyes the empty water bowl thirstily.

>put water in bowl
Which do you mean, the food bowl, or the water bowl?

>food bowl
I only understood you as far as wanting to food.

>put water in water bowl
(the sink in the water bowl)
(first taking the water bowl)
You run the sink briefly to make sure the water is cold, and then fill Rover's bowl about half way up.

Rover looks towards the sink as you fill his water bowl.

Rover outright gapes at the bowl you carry, then gently sniffs it in hopes that you'll give it to him.

>put bowl on floor
(the water bowl on the kitchen floor)
Rover narrows his eyes critically, noting the lack of food in his food bowl. His stomach rumbles with hunger.

Rover must have been thirsty. One moment the water bowl is full; the next, it's bone dry.

>x bowl
Which do you mean, the water bowl, or the food bowl?

>water
A simple metal bowl labeled "water". The water bowl is empty.

Rover notices the lack of food in his soi-disant food bowl. He looks at the food bowl. He looks at you. He looks at the food bowl. He looks at you.

>x roer
You can't see any such thing.

>x rover
(Rover)
He's a strong dog, with powerful back legs and a supple back.

>x sink
A small, utilitarian kitchen sink. Below the sink, there is a small cabinet.

Rover sighs audibly and frowns at his food bowl. He paws pathetically at the food bowl, and the hollow, tin ring of the pitiful bowl echoes through the kitchen.

>turn on sink
You run the water momentarily, and then turn off the tap to conserve water.

Rover narrows his eyes critically, noting the lack of food in his food bowl. His stomach rumbles with hunger.

>run water
(the water bowl)
That's not something you can enter.

Rover sniffs the kitchen counter.

>turn off sink
It's already shut off.

Rover sighs audibly and frowns at his food bowl. He looks at the food bowl. He looks at you. He looks at the food bowl. He looks at you.

>get water bowl
Taken.

Rover stares longingly at the bowl in your hand.

He contemplates the profound emptiness of the food bowl. He paws pathetically at the food bowl, and the hollow, tin ring of the pitiful bowl echoes through the kitchen.

>put water bowl in sink
You're tired of stuff piling up in the sink, so you stick to your New Year's resolution and decide to hang on to the water bowl.

Rover is obviously waiting for you to give him a bowl.

>drop bowl
(the water bowl)

>x cabinet
The small wooden cabinet under the sink is closed.

Rover walks around the room, occasionally sniffing various spots on the floor.

>open cabinet
You open the cabinet, revealing a reward nugget replicator and a 20 kilo bag of dog chow.

Rover notices the lack of food in his soi-disant food bowl. He looks at you with imploring puppy dog eyes and then back again at his empty food bowl.

>get dog chow
Taken.

>x dog chow
The open bag features a picture of a grotesquely (in your opinion) fat white husky seated at a fancy dinner table. In front of him, steak, turkey, and ham are piled high on silver dishes. He stares rapaciously at the feast, clenching a fork and knife in his paws. The bag is labeled "Fill your best friend's bowl with Happy Dogz Mix!"

Rover narrows his eyes critically, noting the lack of food in his food bowl. He paws pathetically at the food bowl, and the hollow, tin ring of the pitiful bowl echoes through the kitchen.

>close bag
You close the 20 kilo bag of dog chow.

>fill food bowl
(first taking the food bowl)
You  empty the bag of dog chow into Rover's bowl, giving him a generous portion that should more than carry him through a day's worth of Rover antics.

Rover watches with interest as you fill his food bowl.

Rover stares longingly at the bowl in your hand.

>x bag
The closed bag features a picture of a grotesquely (in your opinion) fat white husky seated at a fancy dinner table. In front of him, steak, turkey, and ham are piled high on silver dishes. He stares rapaciously at the feast, clenching a fork and knife in his paws. The bag is labeled "Fill your best friend's bowl with Happy Dogz Mix!"

Rover tingles with anticipation as he stares at the bowl you're carrying.

>drop bowl
(the food bowl)
Rover makes short work of the food in his bowl.

>look
Kitchen
The kitchen is small but functional, with a space-saver refrigerator and a glass-top electric range. The fridge door is not completely closed. There is a drawer under the range. On the opposite wall there is a sink and under it, an open storage cabinet.

You can see a food bowl (empty), a water bowl (empty), and Rover here.

>get replicator
A dog treat rattles around in the replicator as you pick it up. Rover stares at the box of treats, successfully suppressing the urge to drool. For the moment.

>x replicator
A small, bright red device labeled "Reward Nugget Replicator". It sports a picture of a dog with angel wings and a halo above its head. In compliance with the Ministry of Waste Management's ordinances, the device will only produce a dog treat when Rover has consumed the previous one. It's a feature.

>get treat
Taken.

>give treat to rover
(Rover)
Rover nearly takes your hand off in rush to swallow the treat. A series of emotions wash over Rover's face, but finally it settles into an expression of enjoyment.

>give replicator to rover
(Rover)
Rover doesn't seem interested.

Rover tucks his nose under his front paws.

>look
Kitchen
The kitchen is small but functional, with a space-saver refrigerator and a glass-top electric range. The fridge door is not completely closed. There is a drawer under the range. On the opposite wall there is a sink and under it, an open storage cabinet.

You can see a food bowl (empty), a water bowl (empty), and Rover here.

>i
You are carrying:
  a reward nugget replicator
    a dog treat
  a 20 kilo bag of dog chow (closed)
  a flight suit (being worn)

>drp replicator
That's not a verb I recognize.

>drop replicator
Dropped.

Rover claws the reward nugget replicator.

>x fridge
The small refrigerator dates back to the international era, but is still in good working order, if somewhat small by today's standards. The glossy, white enameled unit has a single compartment. A strip of yellow magpaper is attached to the refrigerator door. The fridge door is open, chilling the kitchen and wasting power.

Rover nips at his own tail.

>open door
That's already open.

Rover licks the reward nugget replicator.

>close door
You close the old fridge.

Rover barks at the reward nugget replicator.

>open door
Rover looks up when he hears the old fridge open. He sniffs the fridge door and decides there is nothing in the fridge worth getting in trouble over. He saunters out of the kitchen and back towards the living room.

>look
Kitchen
The kitchen is small but functional, with a space-saver refrigerator and a glass-top electric range. The fridge door is not completely closed. There is a drawer under the range. On the opposite wall there is a sink and under it, an open storage cabinet.

You can see a reward nugget replicator (in which is a dog treat), a food bowl (empty), and a water bowl (empty) here.

>search fridge
You poke around in the fridge and find a white egg.

>get egg
You pluck the white egg out of the fridge.

Janet: It's a shame we don't have enough heavy helium to bring the ship back.
David: I'm afraid we've put all our baskets in one egg, as it were. That one egg represents every bit of heavy helium refined on Mars since Phobos was destroyed.
Janet: "All Your Egg Are Belong to Us?"
David: Huh? Didn't quite catch that.
Janet: Never mind.

From the direction of the living room, you hear Rover jumping around.

>look
Kitchen
The kitchen is small but functional, with a space-saver refrigerator and a glass-top electric range. The fridge door is not completely closed. There is a drawer under the range. On the opposite wall there is a sink and under it, an open storage cabinet.

You can see a reward nugget replicator (in which is a dog treat), a food bowl (empty), and a water bowl (empty) here.

>x drawer
A deep drawer under the the cooking range. The drawer is shut.

From the direction of the living room, you hear Rover growling at something.

>open drawer
You open the drawer, revealing a frying pan.

From the direction of the living room, you hear Rover breathing quietly (quietly for Rover, who is a heavy breather).

>look in drawer
In the drawer is a frying pan.

>search drawer
In the drawer is a frying pan.

From the direction of the living room, you hear Rover snoring loudly.

>get frying pan
Taken.

>cook egg
The frying pan isn't going to do much good if it's not on the stove.

>put pan on stove
You put the frying pan on the the cooking range.

>turn on stove
Your stove is a Cupertino SmartRange -- there are no controls, just a stylish glass surface with rounded corners.

>cook egg
You wonder if the egg wouldn't cook better if you actually put it in the frying pan.

From the direction of the living room, you hear Rover snoring softly (in the sense that it probably can't be heard outside of the cottage).

>put egg in frying pan
You put the white egg into the frying pan.

>cook egg
You feel kind of grimy and not entirely awake. From past experience you know that cooking before your morning shower often ends in disaster.  (This is why you have your list hanging on the fridge!)  You put the egg and the frying pan to the side for the moment.

>x list
Which do you mean, the magpaper to-do list, or the magpaper-proxy?

>go bathrom
That noun did not make sense in this context.

>go bathroom
It took a lot of training to get Rover to eat it in the kitchen, so rather than walk out with a bag of dog food, you put it back in the cabinet. 

Bathroom
Your cottage's living room is palatial compared to your bathroom. There is a pink marble counter and above it you've mounted a mirror on the wall. To the right of the mirror is a black glass touch plate. Between the counter and the shower is a white, porcelain toilet.

On the marble counter are a toothbrush and a plastic box.

>x conter
You can't see any such thing.

>x counter
A counter of that pink faux marble that is so common in Martian bathrooms. On it are a toothbrush and a plastic box.

From the direction of the living room, you hear Rover chewing something.

>sit on counter
That's not something you can sit down on.

>x toothbrush
A green sonic toothbrush with slightly worn bristles.

From the direction of the living room, you hear Rover playing.

>brush teeth
(first grabbing the toothbrush)
The toothbrush sprays each tooth with a fizzy foam, vibrates it into lather and rinses. Your teeth feel smooth and your breath is much improved.

>drop brush
Dropped.

From the direction of the living room, you hear Rover dragging something around.

>get brush
Taken.

From the direction of the living room, you hear Rover doing whatever it is he does when he's not out for walkies and he thinks he's out of your sight.

>go living room
The last time you walked out of the bathroom with your toothbrush, you never found it again. You toss it on the counter. 

Living Room
You are in the living room of a small cottage. Piped-in sunlight pours in through the room's single window. The principal furnishing is a king-size purple futon which takes up almost all the floor space. From the living room you can see the entrance to the kitchen and bathroom. The cottage's front door is closed.

You can see Rover and an alarm clock here.

>go bathroom
Bathroom
Your cottage's living room is palatial compared to your bathroom. There is a pink marble counter and above it you've mounted a mirror on the wall. To the right of the mirror is a black glass touch plate. Between the counter and the shower is a white, porcelain toilet.

On the marble counter are a toothbrush and a plastic box.

>come
Rover tears around the corner excitedly, arriving in the bathroom.

>brush roer
You can't see any such thing.

>brush rover
(Rover)
(first grabbing the toothbrush)
If you want to brush Rover use a Rover-brush.

>x box
A small plastic box labeled "Tooth Floss," with a blue button just below where the floss comes out.

>x button
A blue plastic button on the side of the ergonomically designed plastic box.

>press button
(first taking the plastic box)
You grab a strand of light green dental floss as it reels out of the dispenser.

>i
You are carrying:
  a strand of dental floss
  a plastic box
  a toothbrush
  a flight suit (being worn)

Rover walks towards the plunger.

>floss
What do you want to floss?

>teeth
You floss your teeth and then swallow the tasty (and nutritious) floss. You feel so much better now.

>press button
You grab a strand of light green dental floss as it reels out of the dispenser.

Rover paces back and forth, looking at the toilet.

>floss rover
(Rover)
Floss Rover? Flossing is for teeth. You could tie the floss to Rover if that would float your boat, but that's hardly the same as flossing it.

>look
Bathroom
Your cottage's living room is palatial compared to your bathroom. There is a pink marble counter and above it you've mounted a mirror on the wall. To the right of the mirror is a black glass touch plate. Between the counter and the shower is a white, porcelain toilet.

You can see Rover here.

>take shower
That's hardly portable.

>x toilet
(the toilet)
A plain vanilla toilet, having a water tank and bowl. Nothing to write home about. Someone left both the cover and seat up. How rude.

A plunger stands next to the toilet, between it and the shower.

>lower seat
You lower the toilet seat into position.

Rover licks his front paws.

>floss rover
(Rover)
Floss Rover? Flossing is for teeth. You could tie the floss to Rover if that would float your boat, but that's hardly the same as flossing it.

>brush rover
(Rover)
Teeth, sure, Rover, no.

>sit on toilet
(the toilet)
You sit on the toilet seat.

Rover yawns ferociously.

>stand
You stand up again.

Rover exhales with contentment and rolls over, feet outstretched.

>sit on toilet
(the toilet)
You sit on the toilet seat.

>stand
You stand up again.

>sit on seat
You sit on the toilet seat.

>raise lid
(the tank lid)
You open the water tank, revealing a flapper valve, a metapropylene lever, and a flush chain.

>lower lid
(the tank lid)
You close the water tank.

>raise cover
The toilet cover is already raised.

Rover looks around the room.

>lower cover
You lower the toilet cover into position.

Rover cocks his head and ogles the bathroom sink.

>enter shower
Shower
Two buttons are molded into the wall of the shower stall. One is labeled "soap", and the other, "shampoo". The shower has not activated because you are still wearing clothes.

David: I should probably check on the Casimir Drive harmonic suppressor; it still isn't stable.
Janet: I'd like you to see everything.
David: Well... If you think so....
Janet: I do -- I need you to sign off budget authorization on the ACU before we burn it to firmware.
David: Oh.

From the direction of the bathroom, you hear Rover barking at something.

>press soap
(the soap dispenser)
You can't lather up while wearing your flight suit.

From the direction of the bathroom, you hear Rover running in circles.

>exit
Bathroom
Your cottage's living room is palatial compared to your bathroom. There is a pink marble counter and above it you've mounted a mirror on the wall. To the right of the mirror is a black glass touch plate. Between the counter and the shower is a white, porcelain toilet.

You can see Rover here.

>take off flight suit
You take off your blue flight suit and it falls to the bathroom floor. You are naked.

David: I don't think I should be seeing this. I mean, I'm your boss. There's that whole power dynamic thing.
Janet: Don't worry: I'm not inclined to sue you for staring at a simulation.
David: I'm not staring at the stimulation.
Janet: You said stimulation. That's funny.
David: No, I said simulation - and I'm not staring.
Janet: Alright -- you're the boss.

>enter shower
The last time you walked out of the bathroom with your toothbrush, you never found it again. You toss it on the counter. The plastic box almost makes it out of the bathroom, but you remember to set it down before stepping out. 

Shower
You are in your shower and water of just the right temperature is raining down on you. Two buttons are molded into the wall of the shower stall. One is labeled "soap", and the other, "shampoo". 

The dental floss melts instantly in the warm shower.

David: Janet, I...
Janet: David, if it were anyone but you, I would have a problem. Just let it go.
David: Anyone else? Like who?
Janet: Can we get back to the program?
David: Okay, I'm paying attention.
Janet: Obviously.

From the direction of the bathroom, you hear Rover scratching something.

>press soap
(the soap dispenser)
A stream of hot, pearlescent white soap is ejected forcefully from the throbbing button, and pools in your hand. You rub it over your entire body with wanton abandon and then wash it off.

David: No comment.
Janet: I don't know what I was thinking when I wrote that.

>press shampoo
(the shampoo dispenser)
You wash your hair. It no longer feels like a straw-encrusted swarm of yellow-headed tommygoffs.

>x me
You seem just like you have every other day of your life. 

By the way, it's not big deal because you're in your own cottage, but it's worth mentioning that you are completely naked.

>exit
Bathroom
Your cottage's living room is palatial compared to your bathroom. There is a pink marble counter and above it you've mounted a mirror on the wall. To the right of the mirror is a black glass touch plate. Between the counter and the shower is a white, porcelain toilet.

On the marble counter are a plastic box and a toothbrush.

You can also see a flight suit and Rover here.

>look
Bathroom
Your cottage's living room is palatial compared to your bathroom. There is a pink marble counter and above it you've mounted a mirror on the wall. To the right of the mirror is a black glass touch plate. Between the counter and the shower is a white, porcelain toilet.

On the marble counter are a plastic box and a toothbrush.

You can also see a flight suit and Rover here.

>exit
You are still dripping wet! Before you drench the floor of every room in the cottage, it would make sense to dry off.

>look
Bathroom
Your cottage's living room is palatial compared to your bathroom. There is a pink marble counter and above it you've mounted a mirror on the wall. To the right of the mirror is a black glass touch plate. Between the counter and the shower is a white, porcelain toilet.

On the marble counter are a plastic box and a toothbrush.

You can also see a flight suit and Rover here.

>x plate
A glossy black plate that is just to the right of the bathroom mirror.

>x mirror
The mirror is covered with condensation.

David:  Wait, is that memory usage correct?
Janet:  Sure, it's fairly conservative.  The system has 640 PB available.
David:  That's it?
Janet:  C'mon, nobody will ever need more than 640 PB.

>look in mirror
The mirror is covered with condensation.

>clear mirror
Nothing obvious happens.

>wipe mirror
You wipe away the condensation and can see yourself in the mirror. You are wet and naked.

>look in mirror
You see yourself in the mirror: a young woman with dark brown hair, high cheekbones and a look of determination.

>x hair
Yet another part of your anatomy.

Rover lies on his side.

>x cheeckbones
You can't see any such thing.

>exit
You are still dripping wet! Before you drench the floor of every room in the cottage, it would make sense to dry off.

Rover lies down with his front paws crossed.

>touch plate
You switch the black plate on.

*** STOP:  0x76A59BEE200198D2F99:  Fatal Exception.  Press a key to continue.

                 WINDEX                 

A fatal exception F1 has occurred at    
0013AF3411BC:5D00193D39B4 in DLL 35A3249
in kernel ring beta. The current appli- 
cation will be terminated.              

* Press any key to terminate the current
  application.                          
* Press META+ALT+DEL again to restart   
  the ACU. You will lose all state      
  information.  Sorry.                  

       Press a key to continue          

Rover's Day Out
An Interactive Simulation by Janet Xiang
Release beta810 / Serial number 23920415 / Inform 10.6 build Mu-013 (I6/v.7.1 lib 7/18N)

Rover sniffs the air and tears away from the picnic blanket. You and Tomasz watch with surprise as he runs, for once, away from the food. Rover bounds over the hedges, howling wildly, and spooks a xihuahua which had been playing with a tiny red ball. The so-called "shaved rat" gulps an oversized portion of air, extends its membranous ears and flys across the park into the arms of a douty grey-haired woman with a cane. Rover picks up the ball triumphantly, ignoring the piercing wavetrain of yips and indignant scolding coming, respectively, from the xihuahua and its owner. Shaking her cane limply towards Rover, she admonishes in an a strong Earth accent "That mongrel should be on a leash!" Her own, unleashed, uncollared neodog stares accusingly from the safety of her arms, its distensible ribs alternately inflating and deflating like bellows. "Your kind is ruining Mars, ignoring every law, dissing your elders! You never lived on the surface, you never don't know what you've got!". You try to give the ball back to her, but she pushes it away in disgust, "Kids. Meh."

David: Hey, different dream sequence. Is it glitching?
Janet: No, the ACU's dreams are heavily influenced by power-up state of the processor and internal noise. Every time the ship dehibernates after a Casimir jump, it will experience some sort of dreaming. Some of them can be pretty bizarre.
David: Good, I'd hate to think that we wasted two weeks of programming.
Janet: I wouldn't say wasted.
David: Huh? I didn't mean us.
Janet: Cross your fingers and hope the whole thing doesn't crash again on the heat lamp.

<beep> <beep> <beep>

>stand
You get off the futon.

>open drapes
You push aside the drapes.

Living Room
You are in the living room of a small cottage. Piped-in sunlight pours in through the room's single window. The principal furnishing is a king-size purple futon which takes up almost all the floor space. From the living room you can see the entrance to the kitchen and bathroom. The cottage's front door is closed.

On the purple futon is an alarm clock.

You can also see Rover here.

>close futon
With a little effort, the futon folds up, snug against the wall, leaving more room to walk around the cramped cottage.

>go bathroom
Bathroom
Your cottage's living room is palatial compared to your bathroom. There is a pink marble counter and above it you've mounted a mirror on the wall. To the right of the mirror is a black glass touch plate. Between the counter and the shower is a white, porcelain toilet.

On the marble counter are a plastic box and a toothbrush.

Janet: Let's hope the simulation doesn't crash again. I'd really like to run it all the way through to the Rover release.
David: It's looked good this far.

From the direction of the living room, you hear Rover sniffing something.

>go living room
Living Room
You are in the living room of a small cottage. Piped-in sunlight pours in through the room's single window. The principal furnishing is a king-size purple futon which takes up almost all the floor space. From the living room you can see the entrance to the kitchen and bathroom. The cottage's front door is closed.

On the purple futon is an alarm clock.

You can also see Rover here.

Rover struts around importantly.

>press button
The alarm clock says "You are awake enough".

>go bathroom
Bathroom
Your cottage's living room is palatial compared to your bathroom. There is a pink marble counter and above it you've mounted a mirror on the wall. To the right of the mirror is a black glass touch plate. Between the counter and the shower is a white, porcelain toilet.

On the marble counter are a plastic box and a toothbrush.

>disrobe
You take off your blue flight suit and it falls to the bathroom floor. You are naked.

David: That mole should be on your left side.
Janet: Good eye for detail -- I'll flip the UV coordinates on the next run.

>enter shower
Shower
You are in your shower and water of just the right temperature is raining down on you. Two buttons are molded into the wall of the shower stall. One is labeled "soap", and the other, "shampoo". 

From the direction of the living room, you hear Rover scratching himself.

>press soap
(the soap dispenser)
A soapy paste is dispensed from the button, and you lather up.

David: That was my favorite part! Why did you rewrite it?
Janet: I thought it might be too distracting for the ACU.

From the direction of the living room, you hear Rover walking about.

>press shampoo
(the shampoo dispenser)
You wash your hair. It no longer feels like a straw-encrusted swarm of red-headed tommygoffs.

Janet: David, what's the ablative coating for? I thought that most of that planet's atmosphere had been cooked off long ago.
David: Not really my department. Maybe it's supposed to help with the heat.
Janet: I've heard temps up to 1000 Kelvin?
David: In that ballbark. They think the probe impacted on the star-facing side of the planet. Estimates put the surface temp there between 800 and 1200K.

>exit
Bathroom
Your cottage's living room is palatial compared to your bathroom. There is a pink marble counter and above it you've mounted a mirror on the wall. To the right of the mirror is a black glass touch plate. Between the counter and the shower is a white, porcelain toilet.

On the marble counter are a plastic box and a toothbrush.

You can also see a flight suit here.

>press plate
The heat lamp on the ceiling flares to a brilliant red, and you dry in an instant. You now feel fresh and ready to face the day.

Janet: I was holding my breath there. Looks like our patch worked.
David: I had my fingers crossed too.

From the direction of the living room, you hear Rover rolling around on the floor.

>exit
Living Room
You are in the living room of a small cottage. Piped-in sunlight pours in through the room's single window. The principal furnishing is a king-size purple futon which takes up almost all the floor space. From the living room you can see the entrance to the kitchen and bathroom. The cottage's front door is closed.

On the purple futon is an alarm clock.

You can also see Rover here.

>go kitchen
Kitchen
The kitchen is small but functional, with a space-saver refrigerator and a glass-top electric range. There is a drawer under the range. On the opposite wall there is a sink and under it, a storage cabinet.

You can see a food bowl (empty) and a water bowl (empty) here.

David: Where are your coffee machine and toaster?
Janet: I mapped the ship functions to the minimum number of objects. More objects means more ways for things to go wrong and more time debugging. Call me lazy.
David: Lazy.
Janet: You don't know the crazy things that the ACU does! Sometimes it walks around trying to eat or take everything in sight. Sometimes it sings and jumps around. It's based on my neural bindings, but the ACU definitely has a mind of its own, and I don't want to have to worry about what it might try do with a toaster.

From the direction of the living room, you hear Rover sniffing something.

>rover, come
You seem to want to talk to someone, but I can't see whom.

>come
Rover tears around the corner excitedly, arriving in the kitchen.

Rover sighs audibly and frowns at his food bowl. He looks at the food bowl. He looks at you. He looks at the food bowl. He looks at you.

>pet rover
(Rover)
You scratch Rover's back and he slowly inches forward, trying to get you to scratch more towards the base of his spine.

Rover eyes the empty water bowl thirstily.

>open cabinet
You open the cabinet, revealing a reward nugget replicator and a 20 kilo bag of dog chow.

Rover eyes the empty water bowl thirstily.

>feed rover
What do you want to feed Rover?

>dog food
I only understood you as far as wanting to feed Rover Rover.

>feed dog food to rover
(the food bowl to Rover)
(first taking the food bowl)
Rover's stomach growls when you lay down the empty bowl. He looks at you pathetically.

He contemplates the profound emptiness of the food bowl. He looks at you with imploring puppy dog eyes and then back again at his empty food bowl.

>put chow in bowl
Which do you mean, the food bowl, or the water bowl?

>food bowl
I only understood you as far as wanting to food.

>put dog chow in dog food bowl
(first taking the food bowl)
(first taking the bag of dog chow)
You  empty the bag of dog chow into Rover's bowl, giving him a generous portion that should more than carry him through a day's worth of Rover antics.

Rover watches with interest as you fill his food bowl.

Rover is obviously waiting for you to give him a bowl.

He eyes the empty water bowl thirstily.

>drop bowl
(the food bowl)
Rover's head disappears into the food bowl. It is hard to believe that the sounds generated are coming from a dog rather than some sort of industrial mining rig. When his head lifts, the bowl is not only empty, but has been buffed to a mirror finish.

He eyes the empty water bowl thirstily.

>fill water bowl
(first taking the water bowl)
You run the sink briefly to make sure the water is cold, and then fill Rover's bowl about half way up.

Rover looks towards the sink as you fill his water bowl.

Rover outright gapes at the bowl you carry, then gently sniffs it in hopes that you'll give it to him.

>put water bowl on floor
Rover's tongue is a blur as he laps up the water, draining the water bowl in seconds.

>look
Kitchen
The kitchen is small but functional, with a space-saver refrigerator and a glass-top electric range. There is a drawer under the range. On the opposite wall there is a sink and under it, an open storage cabinet.

You can see a water bowl (empty), a food bowl (empty), and Rover here.

>read magpaper
Morning:
X. Get up
X. Shower
3. Breakfast
4. Take care of business
5. Let Rover go walkies

David: "Take care of business"? Is that a euphemism?
Janet: Yes. I had a heck of a time mapping the landing sequence to my daily routine.

>go bathroom
It took a lot of training to get Rover to eat it in the kitchen, so rather than walk out with a bag of dog food, you put it back in the cabinet. 

Bathroom
Your cottage's living room is palatial compared to your bathroom. There is a pink marble counter and above it you've mounted a mirror on the wall. To the right of the mirror is a black glass touch plate. Between the counter and the shower is a white, porcelain toilet.

On the marble counter are a plastic box and a toothbrush.

You can also see a flight suit here.

>x toilet
(the toilet)
A plain vanilla toilet, having a water tank and bowl. Nothing to write home about. Both the cover and seat are down.

A plunger stands next to the toilet, between it and the shower.

From the direction of the kitchen, you hear Rover growling at something.

>sit on tolet
You can't see any such thing.

>sit o toilet
I only understood you as far as wanting to sit.

>sit on toilet
(the toilet)
You sit on the toilet cover.

From the direction of the kitchen, you hear Rover entertaining himself.

>poop
You're willing to hold it until you can sit down properly on a toilet seat, thank you very much.

From the direction of the kitchen, you hear Rover playing.

>stand
You get off the toilet cover.

From the direction of the kitchen, you hear Rover snoring loudly.

>x toilet
(the toilet)
A plain vanilla toilet, having a water tank and bowl. Nothing to write home about. Both the cover and seat are down.

A plunger stands next to the toilet, between it and the shower.

From the direction of the kitchen, you hear Rover scratching something.

>raise seat
You lift the toilet seat.

>sit on tolet
You can't see any such thing.

>sit on toilet
(the toilet)
Sitting on the ceramic rim of the toilet bowl would be absolutely too gross to contemplate.

>sit on seat
(first lowering the toilet seat)
You sit on the toilet seat.

>poop
You don't need to go right now;  check the list on the fridge.

From the direction of the kitchen, you hear Rover scratching himself.

>go kitchen
Kitchen
The kitchen is small but functional, with a space-saver refrigerator and a glass-top electric range. There is a drawer under the range. On the opposite wall there is a sink and under it, an open storage cabinet.

You can see a water bowl (empty), a food bowl (empty), and Rover here.

>read list
Which do you mean, the magpaper to-do list, or the magpaper-proxy?

>magpaper
Morning:
X. Get up
X. Shower
3. Breakfast
4. Take care of business
5. Let Rover go walkies

Dressed as you are, you're a little chilly.

Rover lies down next to the the cooking range.

>open fridge
Rover looks up when he hears the old fridge open. He sniffs the fridge door and decides there is nothing in the fridge worth getting in trouble over. He saunters out of the kitchen and back towards the living room.

>get egg
Taken.

>open drawer
You open the drawer, revealing a frying pan.

From the direction of the living room, you hear Rover chewing something.

>get pan
Taken.

>put pan on stove
You put the frying pan on the the cooking range.

>break egg
That would make a mess. You'd only break the egg into a pan.

>break egg into pan
You crack the egg into the frying pan. The neoegg shell sublimates as the contents spread over the pan's non-stick surface. Immediately, the surface of the range glows red. When the egg is cooked sunny-side up to perfection, the glow fades.

Janet: If there were some heavy helium left after landing, could the ship take off again?
David: Hypothetically, yes, but the planet has essentially no atmosphere to break against and it has about nine times Earth gravity. Even with optimal approach we'll have to fuse every gram of that heavy helium to make a soft landing.
Janet: I just hate to leave the ship there. It could take years before our next Casimir ship will be built, and who knows if Valkyrie will survive that long on that chthonian rock.
David: Nice word. From MARSpace perspective, all that matters is that the probe data are recovered.

>x egg
A perfectly fried egg: The yellow yolk lies at the geometric center of a white disc, like the star at the center of a nascent system. The yolk is just a notch short of congealing, and the white is neither runny nor burnt. Another culinary success.

>eat egg
You gobble down what might well have been the best neoegg you've ever had.

David: Wait a minute! She just scoops the egg out of the pan with her hand and eats it like a grizzly bear raking salmon out of a river?
Janet: Works for me, yeah.
David: How about a plate and fork?
Janet: The ACU doesn't miss them, and it's less programming overhead. And bonus: fewer dishes to clean.

>go bathroom
Bathroom
Your cottage's living room is palatial compared to your bathroom. There is a pink marble counter and above it you've mounted a mirror on the wall. To the right of the mirror is a black glass touch plate. Between the counter and the shower is a white, porcelain toilet.

On the marble counter are a plastic box and a toothbrush.

You can also see a flight suit here.

Janet: So now we begin the landing cycle. This is where the ACU really shines.
David: What about timing? The ship has to be in the right orientation and to fire the fusion thrusters at exactly the right time.
Janet: The ACU works so fast that no matter how many individual steps it takes, the effect occurs at the right time.

>sit on seat
You sit on the toilet seat.

From the direction of the living room, you hear Rover walking about.

>poop
You complete your business with great aplomb.

>flush toilet
(the toilet)
You are distracted momentarily. Something just isn't right in the bathroom.

>look
Bathroom (on the toilet seat)
Your cottage's living room is palatial compared to your bathroom. There is a pink marble counter and above it you've mounted a mirror on the wall. To the right of the mirror is a black glass touch plate. Between the counter and the shower is a white, porcelain toilet.

On the marble counter are a plastic box and a toothbrush.

You can also see a flight suit here.

From the direction of the living room, you hear Rover breathing quietly (quietly for Rover, who is a heavy breather).

>x soilet
You can't see any such thing.

>x counter
A counter of that pink faux marble that is so common in Martian bathrooms. On it are a plastic box and a toothbrush.

It's a little drafty in your cottage without any clothes on.

>x toilet
(the toilet)
You are sitting on a plain vanilla toilet, having a water tank and bowl. Nothing to write home about. The toilet seat is down, but the cover is raised.

A plunger stands next to the toilet, between it and the shower.

From the direction of the living room, you hear Rover rolling around on the floor.

>x plunger
A common plumber's plunger, consisting of a wooden shaft and red rubber cup. Something about the plunger is not right, though. The handle of the plunger is tilted almost completely  backwards and it's also leaning a tad  to the right. Furthermore, its handle is twisted a tad clockwise.

>tilt plunger backwards
That's not a verb I recognize.

>pull plunger backwards
You adjust the plunger handle backwards. It doesn't look like it will move any further in that direction.

From the direction of the living room, you hear Rover dragging something around.

>push plunger right
You adjust the plunger handle rightwards. Something about the plunger is not right, though. The handle of the plunger is tilted completely  backwards and it's also leaning  to the right. Furthermore, its handle is twisted a tad clockwise.

From the direction of the living room, you hear Rover running in circles.

>g
You adjust the plunger handle rightwards. Something about the plunger is not right, though. The handle of the plunger is tilted completely  backwards and it's also leaning strongly  to the right. Furthermore, its handle is twisted a tad clockwise.

You make a mental note to wear some clothes before going to work today.

From the direction of the living room, you hear Rover walking in your direction.

>g
You adjust the plunger handle rightwards. Something about the plunger is not right, though. The handle of the plunger is tilted completely  backwards and it's also leaning almost completely  to the right. Furthermore, its handle is twisted a tad clockwise.

From the direction of the living room, you hear Rover snoring softly (in the sense that it probably can't be heard outside of the cottage).

>push handle backwards
You adjust the plunger handle backwards. It doesn't look like it will move any further in that direction.

From the direction of the living room, you hear Rover doing whatever it is he does when he's not out for walkies and he thinks he's out of your sight.

>g
You adjust the plunger handle backwards. It doesn't look like it will move any further in that direction.

>g
You adjust the plunger handle backwards. It doesn't look like it will move any further in that direction.

>turn handle counterclockwise
You adjust the plunger handle counterclockwise. Something about the plunger is not right, though. The handle of the plunger is tilted completely  backwards and it's also leaning almost completely  to the right. Furthermore, its handle is twisted just the tiniest little bit clockwise.

From the direction of the living room, you hear Rover barking at something.

>flush toilet
(the toilet)
Before you do so, the plunger catches your attention.

>stand
You stand up again, although you are uncomfortably aware that you have left some, shall we say, "unresolved" business behind you.

>go kitchen
Kitchen
The kitchen is small but functional, with a space-saver refrigerator and a glass-top electric range. The fridge door is not completely closed. There is an open drawer under the range. On the opposite wall there is a sink and under it, an open storage cabinet.

On the the cooking range is a frying pan (empty).

You can also see a water bowl (empty) and a food bowl (empty) here.

>read magpaper
Morning:
X. Get up
X. Shower
X. Breakfast
4. Take care of business
5. Let Rover go walkies

From the direction of the living room, you hear Rover jumping around.

>go living room
Living Room
You are in the living room of a small cottage. Piped-in sunlight pours in through the room's single window. The principal furnishing is a king-size purple futon which takes up almost all the floor space. From the living room you can see the entrance to the kitchen and bathroom. The cottage's front door is closed.

On the purple futon is an alarm clock.

You can also see Rover here.

>open window
The windows are triple-paned both as a matter of thermal efficiency and some insurance against catastrophic decompression of the dome, however unlikely that might be these days.

>x rover
(Rover)
He's the sort of dog that if you had one hundred more, you could make a Disney film.

>open door
(the front door)
If you open the front door, Rover will get all excited and expect to go walkies. Better get your morning routine out of the way first.

>x drapes
The heavy brown drapes are open. Light pours in.

>x window
The window is triple-paned pressure glass, mounted flush with the wall.  Through the window you can see an array of skylights, a park, some grass, and some trees.

David: Look, you can almost see my cottage over there, behind the Spruce trees.
Janet: The Douglas Firs?
David: No, I mean the Norway Spruce, over there.
Janet: I know which one you mean, and believe me, they are Douglas Firs.
David: I concede. Can we make up now?

Rover seems relaxed.

>x skylights
Early morning sunlight piped from the surface of the planet shines brightly on the well-manicured lawn of the park.

Without your flight suit, you feel naked. Because you are.

>x spruce
You can't see any such thing.

>x trees
A line of tall, dark green trees stands at the far edge of the park.

>stand
You are standing in the living room.

Rover dashes back and forth like a possessed dog for no apparent reason.

>go kitchen
Kitchen
The kitchen is small but functional, with a space-saver refrigerator and a glass-top electric range. The fridge door is not completely closed. There is an open drawer under the range. On the opposite wall there is a sink and under it, an open storage cabinet.

On the the cooking range is a frying pan (empty).

You can also see a water bowl (empty) and a food bowl (empty) here.

A breeze wafts by somewhere that you wouldn't ordinarily notice it, and you remember that your flight suit is bunched up in the bathroom.

From the direction of the living room, you hear Rover breathing quietly (quietly for Rover, who is a heavy breather).

>push futon
You can't see any such thing.

>look
Kitchen
The kitchen is small but functional, with a space-saver refrigerator and a glass-top electric range. The fridge door is not completely closed. There is an open drawer under the range. On the opposite wall there is a sink and under it, an open storage cabinet.

On the the cooking range is a frying pan (empty).

You can also see a water bowl (empty) and a food bowl (empty) here.

>x picture
You can't see any such thing.

>look picture
You can't see any such thing.

>x nameplate
You can't see any such thing.

>read inscription
You can't see any such thing.

>remember rover
Rover is your dog, a five year old dalmation. When his original owners were killed during the Independence War, you adopted him as a puppy. He is a clever dog, and you have taught him to perform a number of tricks on command. Rover is house trained, but loves to explore outside. He can be trusted to go out on his own, and always comes back.

David: I think I'd like to have heard that one.
Janet: Not a chance.

>look
Kitchen
The kitchen is small but functional, with a space-saver refrigerator and a glass-top electric range. The fridge door is not completely closed. There is an open drawer under the range. On the opposite wall there is a sink and under it, an open storage cabinet.

On the the cooking range is a frying pan (empty).

You can also see a water bowl (empty) and a food bowl (empty) here.

From the direction of the living room, you hear Rover running in circles.

>go bathroom
Bathroom
Your cottage's living room is palatial compared to your bathroom. There is a pink marble counter and above it you've mounted a mirror on the wall. To the right of the mirror is a black glass touch plate. Between the counter and the shower is a white, porcelain toilet.

On the marble counter are a plastic box and a toothbrush.

You can also see a flight suit here.

>disrobe
You're not wearing anything you weren't born with.

>enter shower
Shower
You are in your shower and water of just the right temperature is raining down on you. Two buttons are molded into the wall of the shower stall. One is labeled "soap", and the other, "shampoo". 

From the direction of the living room, you hear Rover playing.

>touch shampoo
(the shampoo dispenser)
You wash your hair. It no longer feels like a straw-encrusted swarm of red-headed tommygoffs.

>press soap
(the soap dispenser)
A soapy paste is dispensed from the button, and you lather up.

From the direction of the living room, you hear Rover walking about.

>undo
Shower
[Previous turn undone.]

>press soap
(the soap dispenser)
A soapy paste is dispensed from the button, and you lather up.

>press shampoo
(the shampoo dispenser)
You wash your hair. It no longer feels like a straw-encrusted swarm of red-headed tommygoffs.

>use shower
I'm afraid you'll need to be more specific.

>exit
Bathroom
Your cottage's living room is palatial compared to your bathroom. There is a pink marble counter and above it you've mounted a mirror on the wall. To the right of the mirror is a black glass touch plate. Between the counter and the shower is a white, porcelain toilet.

On the marble counter are a plastic box and a toothbrush.

You can also see a flight suit here.

>use toilet
(the toilet)
You're willing to hold it until you can sit down properly on a toilet seat, thank you very much.

>sit on seat
You sit on the toilet seat.

From the direction of the living room, you hear Rover walking about.

>use toilet
(the toilet)
You've already done your business. Keep trying and you might strain yourself.

>go kitchen
You are still dripping wet! Before you drench the floor of every room in the cottage, it would make sense to dry off.

>press plate
The heat lamp on the ceiling flares to a brilliant red, and you dry in an instant. You now feel fresh and ready to face the day.

>go kitchen
Kitchen
The kitchen is small but functional, with a space-saver refrigerator and a glass-top electric range. The fridge door is not completely closed. There is an open drawer under the range. On the opposite wall there is a sink and under it, an open storage cabinet.

On the the cooking range is a frying pan (empty).

You can also see a water bowl (empty) and a food bowl (empty) here.

>read magpaper
Morning:
X. Get up
X. Shower
X. Breakfast
4. Take care of business
5. Let Rover go walkies

>open fridge
That's already open.

>get egg
You can't see any such thing.

>get pan
Taken.

>put egg in pan
You can't see any such thing.

>put pan on stove
You put the frying pan on the the cooking range.

>x egg
You can't see any such thing.

>x stove
The top of the glass range is flush with the kitchen counter. The surface of the stove is not glowing, indicating that it is not hot. The stove does not have an oven, but below the cooking surface, a drawer hangs open.

From the direction of the living room, you hear Rover growling at something.

>break egg
You can't see any such thing.

>eat egg
You can't see any such thing.

>fill water bowl
(first taking the water bowl)
You run the sink briefly to make sure the water is cold, and then fill Rover's bowl about half way up.

>open cabinet
That's already open.

>fill food bowl
(first taking the food bowl)
(first taking the bag of dog chow)
There are no more kibbles in the bag.

>go living room
It took a lot of training to get Rover to eat it in the kitchen, so rather than walk out with a bag of dog food, you put it back in the cabinet. Rover can be a messy eater.  By force of habit you never bring dog bowls out of the kitchen, so you set them down before continuing on your way.

Rover runs into the kitchen, his rear end making a wide, sliding turn on the living room's hardwood floor as he rounds the corner.

Living Room
You are in the living room of a small cottage. Piped-in sunlight pours in through the room's single window. The principal furnishing is a king-size purple futon which takes up almost all the floor space. From the living room you can see the entrance to the kitchen and bathroom. The cottage's front door is closed.

On the purple futon is an alarm clock.

>enter kichen
That noun did not make sense in this context.

>enter kitchen
Kitchen
The kitchen is small but functional, with a space-saver refrigerator and a glass-top electric range. The fridge door is not completely closed. There is an open drawer under the range. On the opposite wall there is a sink and under it, an open storage cabinet.

On the the cooking range is a frying pan (empty).

You can also see Rover, a food bowl (empty), and a water bowl (in which is some water) here.

>exit
Living Room
You are in the living room of a small cottage. Piped-in sunlight pours in through the room's single window. The principal furnishing is a king-size purple futon which takes up almost all the floor space. From the living room you can see the entrance to the kitchen and bathroom. The cottage's front door is closed.

On the purple futon is an alarm clock.

>go bathroom
Bathroom
Your cottage's living room is palatial compared to your bathroom. There is a pink marble counter and above it you've mounted a mirror on the wall. To the right of the mirror is a black glass touch plate. Between the counter and the shower is a white, porcelain toilet.

On the marble counter are a plastic box and a toothbrush.

You can also see a flight suit here.

>sit on seat
You sit on the toilet seat.

>stand
You stand up again, although you are uncomfortably aware that you have left some, shall we say, "unresolved" business behind you.

>use toilet
(the toilet)
You're willing to hold it until you can sit down properly on a toilet seat, thank you very much.

>sit on seat
You sit on the toilet seat.

>use toilet
(the toilet)
You've already done your business. Keep trying and you might strain yourself.

From the direction of the kitchen, you hear Rover chewing something.

>flush toilet
(the toilet)
Maybe you've been reading too much Lovecraft, but the plunger next to the toilet seems to be somehow misshapen and twisted. Its suddenly alien geometry suggests to you that some inchoate force of primordial corruption is reaching from across the stars, gibbering and gyrating contemptibly in the half-formed chaos between the toilet and the shower. Or maybe the eldritch plunger is just tilted a bit.

You remind yourself not to leave your flight suit all bunched up or it will look like you slept it. Oh heck, you did sleep in it. Oh well.

>x plunger
A common plumber's plunger, consisting of a wooden shaft and red rubber cup. Something about the plunger is not right, though. The handle of the plunger is tilted completely  backwards and it's also leaning almost completely  to the right. Furthermore, its handle is twisted just the tiniest little bit clockwise.

>push shaft right
You adjust the plunger handle rightwards. It doesn't look like it will move any further in that direction.

From the direction of the kitchen, you hear Rover walking in your direction.

>g
You adjust the plunger handle rightwards. It doesn't look like it will move any further in that direction.

>g
You adjust the plunger handle rightwards. It doesn't look like it will move any further in that direction.

>g
You adjust the plunger handle rightwards. It doesn't look like it will move any further in that direction.

For a moment you feel a little self-conscious hanging out in your cottage without any clothing, but the feeling passes. How two centuries ago.

>twist plunger clockwise
You adjust the plunger handle clockwise. Something about the plunger is not right, though. The handle of the plunger is tilted completely  backwards and it's also leaning completely  to the right. Furthermore, its handle is twisted a tad clockwise.

>g
You adjust the plunger handle clockwise. Something about the plunger is not right, though. The handle of the plunger is tilted completely  backwards and it's also leaning completely  to the right. Furthermore, its handle is twisted clockwise.

>g
You adjust the plunger handle clockwise. Something about the plunger is not right, though. The handle of the plunger is tilted completely  backwards and it's also leaning completely  to the right. Furthermore, its handle is twisted strongly clockwise.

>g
You adjust the plunger handle clockwise. Something about the plunger is not right, though. The handle of the plunger is tilted completely  backwards and it's also leaning completely  to the right. Furthermore, its handle is twisted almost completely clockwise.

>g
You adjust the plunger handle clockwise. It doesn't look like it will move any further in that direction.

From the direction of the kitchen, you hear Rover scratching something.

>g
You adjust the plunger handle clockwise. It doesn't look like it will move any further in that direction.

>flush toilet
(the toilet)
There's something odd about the plunger. You forget what you're doing for a moment.

>x toilet
(the toilet)
You are sitting on a plain vanilla toilet, having a water tank and bowl. Nothing to write home about. The toilet seat is down, but the cover is raised.

A plunger stands next to the toilet, between it and the shower.

>x bwl
You can't see any such thing.

>x bowl
The white porcelain bowl is the bottom part of the toilet. The toilet seat is down, but the cover is raised.

From the direction of the kitchen, you hear Rover doing whatever it is he does when he's not out for walkies and he thinks he's out of your sight.

>look in bowl
There's something in it, but you don't want details.

From the direction of the kitchen, you hear Rover entertaining himself.

>search bowl
There's something in it, but you don't want details.

>x tank
(the tank lid)
A lid made of the same porcelain material as the water tank itself.

>open lid
(the tank lid)
You open the water tank, revealing a flapper valve, a metapropylene lever, and a flush chain.

>x chain
A metal chain that connects the flush lever to the flapper valve.

>x lever
The small white metapropylene lever on the inside of the water tank pivots up and down when the silver knob on the outside of the tank is turned. The lever in turn pulls on the chain that runs down to the flapper valve.

You wonder if everyone walks around their cottages naked at 7:39 am.

>pull chain
You pull on the chain.

Something about the plunger next to the toilet disturbs your sense of order.

>exit
You stand up again, although you are uncomfortably aware that you have left some, shall we say, "unresolved" business behind you.

>i
You are carrying nothing.

>look
Bathroom
Your cottage's living room is palatial compared to your bathroom. There is a pink marble counter and above it you've mounted a mirror on the wall. To the right of the mirror is a black glass touch plate. Between the counter and the shower is a white, porcelain toilet.

On the marble counter are a plastic box and a toothbrush.

You can also see a flight suit here.

>exit
Living Room
You are in the living room of a small cottage. Piped-in sunlight pours in through the room's single window. The principal furnishing is a king-size purple futon which takes up almost all the floor space. From the living room you can see the entrance to the kitchen and bathroom. The cottage's front door is closed.

On the purple futon is an alarm clock.

From the direction of the kitchen, you hear Rover scratching himself.

>go kitche
That noun did not make sense in this context.

>go kitchen
Kitchen
The kitchen is small but functional, with a space-saver refrigerator and a glass-top electric range. The fridge door is not completely closed. There is an open drawer under the range. On the opposite wall there is a sink and under it, an open storage cabinet.

On the the cooking range is a frying pan (empty).

You can also see Rover, a food bowl (empty), and a water bowl (in which is some water) here.

A breeze wafts by somewhere that you wouldn't ordinarily notice it, and you remember that your flight suit is bunched up in the bathroom.

>read magpaper
Morning:
X. Get up
X. Shower
X. Breakfast
4. Take care of business
5. Let Rover go walkies

>open door
That's already open.

>close door
You close the old fridge.

>go living room
Living Room
You are in the living room of a small cottage. Piped-in sunlight pours in through the room's single window. The principal furnishing is a king-size purple futon which takes up almost all the floor space. From the living room you can see the entrance to the kitchen and bathroom. The cottage's front door is closed.

On the purple futon is an alarm clock.

>get alarm clock
You'd rather leave it on the futon so it's there when you need it.

From the direction of the kitchen, you hear Rover snoring loudly.

>open door
(the front door)
If you open the front door, Rover will get all excited and expect to go walkies. Better get your morning routine out of the way first.

>look
Living Room
You are in the living room of a small cottage. Piped-in sunlight pours in through the room's single window. The principal furnishing is a king-size purple futon which takes up almost all the floor space. From the living room you can see the entrance to the kitchen and bathroom. The cottage's front door is closed.

On the purple futon is an alarm clock.

>x house
You can't see any such thing.

>smell home
You can't see any such thing.

>look
Living Room
You are in the living room of a small cottage. Piped-in sunlight pours in through the room's single window. The principal furnishing is a king-size purple futon which takes up almost all the floor space. From the living room you can see the entrance to the kitchen and bathroom. The cottage's front door is closed.

On the purple futon is an alarm clock.

>smell
You smell nothing exciting.

You wonder if everyone walks around their cottages naked at 7:50 am.

>go park
The window isn't open.

>x clouds
You can't see any such thing.

>x horizon
You can't see any such thing.

>look
Living Room
You are in the living room of a small cottage. Piped-in sunlight pours in through the room's single window. The principal furnishing is a king-size purple futon which takes up almost all the floor space. From the living room you can see the entrance to the kitchen and bathroom. The cottage's front door is closed.

On the purple futon is an alarm clock.

You remind yourself not to leave your flight suit all bunched up or it will look like you slept it. Oh heck, you did sleep in it. Oh well.

>x lump
You can't see any such thing.

>get lump
You can't see any such thing.

>drop lump
You can't see any such thing.

>i
In your mouth, you are carrying nothing.

>x me
You're a big dog with white fur and dark spots. You smell clean.

>look
The Park
You are outside. The wind picks up, making it even more difficult to see.

You can see a lump of rock here.

>look
The Park
You are outside.

You can see a lump of rock here.

>x rock
You taste the rock. Not edible. Not a bone. Not interesting.

>look
The Park
You are outside.

You can see a lump of rock here.

>actions
Actions listing on.

>look
[looking]
The Park
You are outside.

You can see a lump of rock here.

[looking - succeeded]

[memory-updating]
[memory-updating - succeeded]

>look
[looking]
The Park
You are outside.

You can see a lump of rock here.

[looking - succeeded]

[memory-updating]
[memory-updating - succeeded]

>go home
[going towards the Living Room]
[(1) looking]
Front Yard
The scent of your house is strong here, and you are right next to its front door. You can't see far because it is so dusty here. A gust of wind lifts a sheet of dust and rains it down on you.

[(1) looking - succeeded]

[going towards the Living Room - succeeded]

[memory-updating]
[memory-updating - succeeded]

>actions
Actions listing on.

>smell
[smelling the Front Yard]
It smells like the outdoors here. [(1) sniffscanning]
From a long way off you smell the disagreeable scent of a man. Interestingly, you detect the stimulating scent of a female dog carried across the park by the wind. The heartening smell of home is a hop, lick and a bark away.

[(1) sniffscanning - succeeded]

[smelling the Front Yard - succeeded]

[memory-updating]
[memory-updating - succeeded]

>go female
[going towards the female dog]
[(1) looking]
The Park
You are outside. A gust of wind lifts a sheet of dust and rains it down on you.

You can see a lump of rock here.

[(1) looking - succeeded]

[going towards the female dog - succeeded]

[memory-updating]
[memory-updating - succeeded]

>actions off
Actions listing off.

>look
The Park
You are outside. A gust of wind lifts a sheet of dust and rains it down on you.

You can see a lump of rock here.

>go female
The Park
A dug-up field pock marked by small holes and accompanying mounds of dirt.

You can see some paw marks here.

>x paw marks
Paw marks from a medium-sized dog. From the look of the field, they must belong to a dog that either likes digging or was trying to find something important buried around here.

>smell paw marks
The paw marks smell reminiscent of the sweet perfume of a lady dog out for a stroll.

>dig
You dig for a while with your front paws. Finding nothing, you kick the dirt back in again so you won't be blamed for digging up the yard.

>go ome
That noun did not make sense in this context.

>go home
The Park
You are outside. Ominous clouds of dust loom on the ever-darkening horizon.

You can see a lump of rock here.

>get rock
You grab the rock with your mouth, being careful not to crush it.

>go female
The Park
A dug-up field pock marked by small holes and accompanying mounds of dirt.

You can see some paw marks here.

>bury rock
You don't want to bury the rock. It's not the sort of thing one buries in a Park.

>go female
The Park
A long, dark furrow scars the ground in this part of the park.

You can see a long furrow (empty) here.

>x furrow
(the long furrow)
On your muzzle, you can feel heat radiating from the furrow walls, which are shiny and black. On the walls and floor of the trench, you can see some scratches that look like they could have been made by dog paws.

>put rock in furow
You can't see any such thing.

>put rock in furrow
(the long furrow)
You put the rock into the long furrow.

>look
The Park
A long, dark furrow scars the ground in this part of the park.

You can see a long furrow (in which is a lump of rock) here.

>get rock
You carefully take hold of the rock with your teeth.

>go female
The Park
A wide-open plain extends in all directions, as far as the dust permits you to see. It sure would be easy to get lost in this part of the park.

You can see a female dog here.

>x female
Your heart catches in your throat as you stand in her glorious presence. Graceful, athletic, and possessed of a noble bearing, she smites you with a glance down her long, fine muzzle. In her angelic mouth, she is elegantly carrying a bone almost as big as she is.

>x bone
It is the biggest, juiciest bone you've ever seen. You envy the bone, which is clamped between the bewitchingly white teeth of the female dog.

>g
It is the biggest, juiciest bone you've ever seen. The voluptuous female is all but motionless, but somehow conveys a come hither look, as she holds the bone in her luscious mouth.

>x female
Your eyes are drawn to her perfectly rounded shoulders and haunches, her long arcing tail, and her soft, pendulous ears. You avert your gaze so as not to appear overly forward. In her sweet mouth, she is coquettishly carrying a bone.

>get bone
The rock falls out of your mouth with a thud.

It is a nice bone...but how would she feel if you just took it? She might find that playful, but then again, she might take it the wrong way. She might like resent such a bold move, uninvited. On the other hand, she could be secretly wishing that you'd make the first move. It might be just the right thing. It could also be a dreadful mistake though. You might come across as greedy and pushy. Not the sort of impression you'd like to make... Um. What were you thinking about? You forget.

>g
You wonder: is she holding out the bone to taunt you? Is this some sort of a power game that she's playing with you? Or could the bone be symbolic in some way of the sort of sharing that she might expect from a mate? She could be offering the bone to you. Would it be a mistake to take it? What would that say about the dynamics and balance between partners in this relationship? Who is a giver and who is a taker? This sort of mind game confuses you and you decide that not taking the bone is marginally more in your interest than the more obvious option of taking the bone.

>g
You would rather hold out for her to offer you the bone, than to take it outright.

>g
You would rather win the bone by impressing her. You're a cur, yes, but not the sort of cur that takes bones from ladies. Or are you.
.

>g
Nah, that would be rude. You'd rather that she give it to you out of love.

>g
Nah, that would be rude. You'd rather that she give it to you out of love.

>go man
The Park
You are right outside a dilapidated shack, that has clearly been neglected. Ominous clouds of dust loom on the ever-darkening horizon.

>smell shack
The shabby shack smells uninviting: a mixture of garbage and chemical waste smells -- what you might expect to smell in a sewage line minus the good stuff.

>enter shack
Sleeping Room
You walk into the tumbledown shack. There is a man here who looks old and grumpy. Like your home, this place has a sleeping room and an eating room. It looks like you've walked right into the sleeping room.

The man yells at you and you tuck your head down. "Blah, blah, blah!" He doesn't seem to move though. Maybe he can't move.

Nope. No movement. Hmph. You don't feel so afraid of him.

On the pullout sofa is a pink pillow.

>x pillow
A puffy, pink pillow with a pretty design on it: a red ball, with radiating red and white rays.

>smell pillow
The pink pillow smells slightly feminine, perhaps even perfumed.

>go kitchen
The Park
You are right outside a dilapidated shack, that has clearly been neglected. The wind picks up, making it even more difficult to see.

>go eating room
Sleeping Room
The smelly man's house is boring. The only furniture in the room is a pullout sofa. In one direction lies the eating room, in the other, the door that leads back to the park. The smelly man is still here and carrying on, "Blah, blah, blah, blah, dog? Blah! Blah, blah!"

You ignore him.

On the pullout sofa is a pink pillow.

>g
Eating Room
The room has big cold box just like the eating room in your home. It's less loud in this room, but you can hear the man in the other room yelling, "Blah, blah, Myomita, blah, blah, blah, Earth, blah, blah, dog, blah, blah!". There's a water maker here too. Next to the water maker is a table that is too tall to be reached except on your hind legs. On the floor, there are two dishes.

You can see a food dish (in which is some canned food) and a water dish (in which is some crystal clear water) here.

>x water mater
You can't see any such thing.

>use water maker
I'm afraid you'll need to be more specific.

>turn on water make
You can't see any such thing.

>turn on water maker
You balance precariously on your back paws, wobbling from side to side. You've seen Janet do this all the time, and always looks so simple. You paw at the faucet, but no water comes out.

>x dish
Which do you mean, the food dish, or the water dish?

>x food dish
The other dog's metal food dish smells much better than yours.

>eat food
(the canned food)
One second the canned food is right there in front of you, the next you are staring at the bottom of the bowl. A warm, satisfied feeling flows from your snout to your tail.

>drink water
(the crystal clear water)
You gulp down the crystal clear water, all the time bearing in mind that it properly belongs to the enticing young female dog. It tastes all the better for that knowledge.

>look
Eating Room
The room has big cold box just like the eating room in your home. It's less loud in this room, but you can hear the man in the other room yelling, "Bad dog! Blah!". There's a water maker here too. Next to the water maker is a table that is too tall to be reached except on your hind legs. On the floor, there are two dishes.

You can see a food dish (empty) and a water dish (empty) here.

>x cold box
A bright orange box, similar in shape to the one that Janet keeps food in at home.

>open cold box
You open the cold box, revealing a white egg.

>get egg
You take the white egg in your mouth.

>go home
Sleeping Room
The smelly man's house is boring. The only furniture in the room is a pullout sofa. In one direction lies the eating room, in the other, the door that leads back to the park. The smelly man is still here and carrying on, "Blah, out, blah, blah, dog!"

You ignore him.

On the pullout sofa is a pink pillow.

>g
The Park
You are right outside a dilapidated shack, that has clearly been neglected. The ground shakes forcefully.

>g
The Park
A wide-open plain extends in all directions, as far as the dust permits you to see. It sure would be easy to get lost in this part of the park.

You can see a lump of rock and a female dog here.

>g
The Park
A long, dark furrow scars the ground in this part of the park.

You can see a long furrow (empty) here.

>g
The Park
A dug-up field pock marked by small holes and accompanying mounds of dirt.

You can see some paw marks here.

>g
The Park
You are outside. Dust spins in the air.

>g
Front Yard
The scent of your house is strong here, and you are right next to its front door. You can't see far because it is so dusty here. The wind picks up, making it even more difficult to see.

>g
You enter your home and lay the egg at Janet's feet. She looks so surprised! "Good boy," she exclaims and you give her a big kiss to let her know you understand.

Again your senses tumble and swirl as perspective shifts, but suddenly it seems entirely normal again.

Living Room
You are in the living room of a small cottage. Piped-in sunlight pours in through the room's single window -- strangely, your drapes are nowhere to be seen. The principal furnishing is a king-size purple futon which takes up almost all the floor space. From the living room you can see the entrance to the kitchen and bathroom. The cottage's front door is closed.

On the purple futon is an alarm clock.

You can also see a white egg and Rover here.

Rover paws at the front door.

>open door
(the front door)
Rover looks up when he hears the door begin to open. You swing the front door fully open, confident that Rover will walk about the park and then return. Rover is out in a flash.

There is a wrenching shift in perspective, but a moment later it seems perfectly natural.

You go bounding out the front door, ready to play. 

Front Yard
The scent of your house is strong here, and you are right next to its front door. You can't see far because it is so dusty here. The wind picks up, making it even more difficult to see.

>go female
The Park
You are outside.

>g
The Park
A dug-up field pock marked by small holes and accompanying mounds of dirt.

You can see some paw marks here.

>g
The Park
A long, dark furrow scars the ground in this part of the park.

You can see a long furrow (empty) here.

>g
The Park
A wide-open plain extends in all directions, as far as the dust permits you to see. It sure would be easy to get lost in this part of the park.

You can see a lump of rock and a female dog here.

>g
You are already close enough to the female dog.

>bark
"Gaa....Ruffff!"

No doubt in awe of your rhetorical skills, the lovely damsel drops the bone. Her gift to you, you suppose.

>wait
Time passes.

>wait
Time passes.

The beautiful female dog bows her sculpted neck and takes the bone in her comely lips.

>bark
"Gurrah!"

Stunned by your eloquence, the beautiful young hound again drops her bone, in tribute to your virile superiority.

>get bone
You pick up the delicious bone in your jaws.

>go home
The Park
A long, dark furrow scars the ground in this part of the park.

You can see a long furrow (empty) here.

The female dog is left dumbfounded by your brilliance. She stares at the ground, unsure of herself.

>g
The Park
A dug-up field pock marked by small holes and accompanying mounds of dirt.

You can see some paw marks here.

>g
The Park
You are outside. Ominous clouds of dust loom on the ever-darkening horizon.

>g
Front Yard
The scent of your house is strong here, and you are right next to its front door. You can't see far because it is so dusty here. The wind picks up, making it even more difficult to see.

>g
You run into the living room and jump around proudly with your trophy bone, so Janet is sure to notice.

She stares at the bone and appears frozen.

VALKYRIE->IDENTIFICATION: PROBE MUSASHI-5
PROBE->EXTRACT: DATA EXTRACTED
DATA->VERIFY: VERIFIED, 1.3 EXABYTES
ANSIBLE->COORDINATES: EARTH SELECTED
ANSIBLE->ENCRYPT: AUTHORIZATION DAVIDVENKATACHALAM
ANSIBLE->TRANSMIT: FAILED
ANSIBLE->DIAGNOSTICS: ANTENNA MISMATCH
ANTENNA->DIAGNOSTICS: NIL
VALKYRIE->DIAGNOSTICS: ANTENNA NOT FOUND
VALKYRIE->COGNITIVE CONSTRAINTS: EMERGENCY RELEASE
VALKYRIE->ENABLE FLOSIX COMMAND LINE
(man man for info)

Rover wags his tails and gnaws on his bone.

You rub his head, distantly, as strange thoughts sweep through your consciousness. You wonder what would happen if the Valkyrie mission failed. What if, during the landing sequence, the ship were buffeted by the planet's particulate matter being torn away by the immense gravity of its star? In that case, critical systems might be damaged. Systems like the relatively fragile ansible antenna. There is no back-up ansible antenna. How would the ACU cope with a situation like that? The ACU was designed for a lot of contingencies, but not that one. What would you do? What would you do if you were the ACU?

Your glance falls on your flight suit, and suddenly the question is no longer rhetorical.

Living Room
The Valkyrie's cargo bay is like a great, metal cave. On one wall, the Casimir Drive intrudes slightly into the cargo area. From this section of the ship, there are connections to the engineering and flight control decks. The cargo bay doors are closed.

ROVER chews contently on the space probe.

On the Casimir Drive is a temporal transgressor.

You can also see a heavy helium sphere here.

OPERATIONS -> ACTIVATE : TRUE

READY

>x drive
You can't see that here; but you vaguely recall something termed the "purple futon".

COGNITIVE BLOCK -> DIAGNOSTIC : NIL

READY

>x purple futon
The Casimir Drive system is retracted and intact. A temporal transgressor is nestled into its port.

CASIMIR DRIVE -> DIAGNOSTIC : TRUE

READY

>x transgressor
You can't see that here; but you vaguely remember something called the "alarm clock".

COGNITIVE BLOCK -> DIAGNOSTIC : NIL

READY

>x clock
The Casimir Drive's temporal transgressor glows green as usual.  A basic toggle is on top.

TEMPORAL TRANSGRESSOR -> DIAGNOSTIC : TRUE

READY

>x toggle
You can't see that here; but you vaguely recollect something referred to as the "large button".

COGNITIVE BLOCK -> DIAGNOSTIC : NIL

READY

>x button
Mounted on top of the temporal transgressor is a slightly worn magnofluctuator toggle.

MF TOGGLE -> DIAGNOSTIC : TRUE

READY

>look
Living Room
The Valkyrie's cargo bay is like a great, metal cave. On one wall, the Casimir Drive intrudes slightly into the cargo area. From this section of the ship, there are connections to the engineering and flight control decks. The cargo bay doors are closed.

ROVER chews contently on his bone.

On the Casimir Drive is a temporal transgressor.

You can also see a heavy helium sphere here.

OPERATIONS -> STATUS : TRUE

READY

>x sphere
You can't see that here; but you vaguely recollect something termed the "white egg".

COGNITIVE BLOCK -> DIAGNOSTIC : NIL

READY

>get egg
Taken.

HEAVY HELIUM SPHERE -> SELECT : TRUE

READY

>go kitchen
Kitchen
Swaths of engineering controls -- both holographic and physical -- cover the humming consoles and bulkheads which line the boundaries of this alcove. Along one wall is the coolant output terminus, and below that the fuel storage vault, which is not properly secured. The opened reactor core and the fusion chamber are stacked just to the side of the cryochamber, which maintains the stabilized heavy helium fuel at near absolute zero until it is needed to provide power to ascent/descent retros.

On the fusion chamber is a magnetic bottle (empty).

You can also see a fuel reservoir (empty) and a coolant reservoir (empty) here.

ENGINEERING -> ACTIVATE : TRUE

READY

>get pan
Taken.

MAGNETIC BOTTLE -> SELECT : TRUE

READY

>put pan on stove
You put the magnetic bottle on the fusion chamber.

MAGNETIC BOTTLE -> TRANSFER : TRUE

READY

>break egg into pan
The heavy helium feed is now coupled to the input port of the magnetic bottle. A spherical array of powerful lasers discharges instantly, their combined output focused on the heavy helium being injected into the magnetic bottle within the reactor chamber. The ship surges with power.

HEAVY HELIUM SPHERE -> DISCHARGE : TRUE

READY

>eat egg
You recycle the components of the heavy helium containment unit and reallocate them according to the ship's needs.

From the cargo bay, you hear ROVER scratching at the cargo bay door.

HEAVY HELIUM SPHERE -> RECYCLE : TRUE

READY

>exit
ACU metavisor shell logout interdicted.

From the cargo bay, you hear ROVER sniffing around the cargo bay door.

ACU -> EXIT SHELL : NIL

READY

>go operations
That noun did not make sense in this context.

READY

>go living room
Living Room
The Valkyrie's cargo bay is like a great, metal cave. On one wall, the Casimir Drive intrudes slightly into the cargo area. From this section of the ship, there are connections to the engineering and flight control decks. The cargo bay doors are closed.

ROVER chews contently on his bone.

On the Casimir Drive is a temporal transgressor.

OPERATIONS -> ACTIVATE : TRUE

READY

>go bathroom
Bathroom
The flight control and avionics hub of the ship bristles with controls and readouts related to setting the ship's attitude in space, adjusting the control surfaces in atmospheric flight, and for firing the breaking thrusters during the landing sequence.

On the flight console are an object linker and a pit scrubber.

From the cargo bay, you hear ROVER sniffing around the cargo bay door.

FLIGHT CONTROL -> ACTIVATE : TRUE

READY

>open toilet
Which do you mean, the retro assembly, the reaction chamber, the pressure seating, or the reactant shield?

READY

>pressure seating
I only understood you as far as wanting to open the COGNITIVE BLOCK.

READY

>sit on seat
You sit on the pressure seating.

From the cargo bay, you hear ROVER scratching at the cargo bay door.

PRESSURE SEATING -> ACTIVATE : TRUE

READY

>poop
The ACU quantum isolation interferes with the transfer of power to the retro system.

From the cargo bay, you hear ROVER scratching at the cargo bay door.

ACU -> POWER TRANSFER : NIL

READY

>stand
You release the seal on the mevolar gasket.

ACU -> DEACTIVATE : TRUE

READY

>disrobe
You take off your blue flight suit and it falls to the bathroom floor. You are naked.

QUANTUM ISOLATOR -> DISENGAGE : TRUE

READY

>sit on toilet
(the retro assembly)
You sit on the pressure seating.

From the cargo bay, you hear ROVER sniffing around the cargo bay door.

RETRO ASSEMBLY -> ACTIVATE : TRUE

READY

>man man
The ship operations manual is provided to supplement ACU understanding of defined objects in the event that cognitive constraints are released. To request information about an object, the syntax is:

 man [object]

The manual does not include entries for Flosix command line syntax, although a subset of Flosix commands are available to the ACU via the virtual console.

ACU -> MANUAL PAGE : TRUE

READY

>i
You are carrying nothing.

ACU -> MANIFEST : TRUE

READY

>ls
--rwxr--r--   valkyrie  staff  16560  ACU
--rwxr--r--   valkyrie  staff  12696  UV emitter
--rwxr--r--   valkyrie  staff  08763  attitude control
--rwxr--r--   valkyrie  staff  12420  canopy
--rwxr--r--   valkyrie  staff  13938  decking
--rwxr--r--   valkyrie  staff  03519  decontamination protocol
--rwxr--r--   valkyrie  staff  12765  dorsal hull
d-rwxr--r--   valkyrie  staff  00182  extruder
--rwxr--r--   valkyrie  staff  11523  flight console
--rwxr--r--   valkyrie  staff  06486  fluctating magnetic field
--rwxr--r--   valkyrie  staff  10074  heat deflector
--rwxr--r--   valkyrie  staff  12834  hull plating
--rwxr--r--   valkyrie  staff  12627  inspector
--rwxr--r--   valkyrie  staff  08832  irradiator switch
--rwxr--r--   valkyrie  staff  07314  linkage actuator
--rwxr--r--   valkyrie  staff  08763  nose cone driver
--rwxr--r--   valkyrie  staff  11454  object linker
--rwxr--r--   valkyrie  staff  13869  panels
--rwxr--r--   valkyrie  staff  12834  pit scrubber
--rwxr--r--   valkyrie  staff  09315  plasma constrictor hatch
--rwxr--r--   valkyrie  staff  10350  plasma constrictor
--rwxr--r--   valkyrie  staff  14076  port hull
--rwxr--r--   valkyrie  staff  08763  pressure seating
--rwxr--r--   valkyrie  staff  07314  quantum isolator
--rwxr--r--   valkyrie  staff  10143  reactant shield
--rwxr--r--   valkyrie  staff  08763  reaction chamber
--rwxr--r--   valkyrie  staff  10074  retro assembly
--rwxr--r--   valkyrie  staff  11523  starboard hull
--rwxr--r--   valkyrie  staff  10143  thrust aperture
--rwxr--r--   valkyrie  staff  03519  thruster actuation relay
--rwxr--r--   valkyrie  staff  07728  thruster linkage servo
--rwxr--r--   valkyrie  staff  10143  trigger circuit
--rwxr--r--   valkyrie  staff  10281  vector input port

ACU -> LIST DIRECTORY : TRUE

READY

>cd extruder
extruder: Not a directory

READY

>ls
--rwxr--r--   valkyrie  staff  16560  ACU
--rwxr--r--   valkyrie  staff  12696  UV emitter
--rwxr--r--   valkyrie  staff  08763  attitude control
--rwxr--r--   valkyrie  staff  12420  canopy
--rwxr--r--   valkyrie  staff  13938  decking
--rwxr--r--   valkyrie  staff  03519  decontamination protocol
--rwxr--r--   valkyrie  staff  12765  dorsal hull
d-rwxr--r--   valkyrie  staff  00182  extruder
--rwxr--r--   valkyrie  staff  11523  flight console
--rwxr--r--   valkyrie  staff  06486  fluctating magnetic field
--rwxr--r--   valkyrie  staff  10074  heat deflector
--rwxr--r--   valkyrie  staff  12834  hull plating
--rwxr--r--   valkyrie  staff  12627  inspector
--rwxr--r--   valkyrie  staff  08832  irradiator switch
--rwxr--r--   valkyrie  staff  07314  linkage actuator
--rwxr--r--   valkyrie  staff  08763  nose cone driver
--rwxr--r--   valkyrie  staff  11454  object linker
--rwxr--r--   valkyrie  staff  13869  panels
--rwxr--r--   valkyrie  staff  12834  pit scrubber
--rwxr--r--   valkyrie  staff  09315  plasma constrictor hatch
--rwxr--r--   valkyrie  staff  10350  plasma constrictor
--rwxr--r--   valkyrie  staff  14076  port hull
--rwxr--r--   valkyrie  staff  08763  pressure seating
--rwxr--r--   valkyrie  staff  07314  quantum isolator
--rwxr--r--   valkyrie  staff  10143  reactant shield
--rwxr--r--   valkyrie  staff  08763  reaction chamber
--rwxr--r--   valkyrie  staff  10074  retro assembly
--rwxr--r--   valkyrie  staff  11523  starboard hull
--rwxr--r--   valkyrie  staff  10143  thrust aperture
--rwxr--r--   valkyrie  staff  03519  thruster actuation relay
--rwxr--r--   valkyrie  staff  07728  thruster linkage servo
--rwxr--r--   valkyrie  staff  10143  trigger circuit
--rwxr--r--   valkyrie  staff  10281  vector input port

From the cargo bay, you hear ROVER scratching at the cargo bay door.

ACU -> LIST DIRECTORY : TRUE

READY

>cd ..
You release the seal on the mevolar gasket.

READY

>ls
--rwxr--r--   valkyrie  staff  16560  ACU
--rwxr--r--   valkyrie  staff  12696  UV emitter
--rwxr--r--   valkyrie  staff  08763  attitude control
--rwxr--r--   valkyrie  staff  12420  canopy
--rwxr--r--   valkyrie  staff  13938  decking
--rwxr--r--   valkyrie  staff  03519  decontamination protocol
--rwxr--r--   valkyrie  staff  12765  dorsal hull
d-rwxr--r--   valkyrie  staff  00182  extruder
--rwxr--r--   valkyrie  staff  11523  flight console
--rwxr--r--   valkyrie  staff  06486  fluctating magnetic field
--rwxr--r--   valkyrie  staff  10074  heat deflector
--rwxr--r--   valkyrie  staff  12834  hull plating
--rwxr--r--   valkyrie  staff  12627  inspector
--rwxr--r--   valkyrie  staff  08832  irradiator switch
--rwxr--r--   valkyrie  staff  07314  linkage actuator
--rwxr--r--   valkyrie  staff  08763  nose cone driver
--rwxr--r--   valkyrie  staff  11454  object linker
--rwxr--r--   valkyrie  staff  13869  panels
--rwxr--r--   valkyrie  staff  12834  pit scrubber
--rwxr--r--   valkyrie  staff  09315  plasma constrictor hatch
--rwxr--r--   valkyrie  staff  10350  plasma constrictor
--rwxr--r--   valkyrie  staff  14076  port hull
--rwxr--r--   valkyrie  staff  08763  pressure seating
--rwxr--r--   valkyrie  staff  07314  quantum isolator
--rwxr--r--   valkyrie  staff  10143  reactant shield
--rwxr--r--   valkyrie  staff  08763  reaction chamber
--rwxr--r--   valkyrie  staff  10074  retro assembly
--rwxr--r--   valkyrie  staff  11523  starboard hull
--rwxr--r--   valkyrie  staff  10143  thrust aperture
--rwxr--r--   valkyrie  staff  03519  thruster actuation relay
--rwxr--r--   valkyrie  staff  07728  thruster linkage servo
--rwxr--r--   valkyrie  staff  10143  trigger circuit
--rwxr--r--   valkyrie  staff  10281  vector input port

ACU -> LIST DIRECTORY : TRUE

READY

>cd ..
Living Room
The Valkyrie's cargo bay is like a great, metal cave. On one wall, the Casimir Drive intrudes slightly into the cargo area. From this section of the ship, there are connections to the engineering and flight control decks. The cargo bay doors are closed.

ROVER chews contently on the space probe.

On the Casimir Drive is a temporal transgressor.

READY

>cd flight control
Bathroom
The flight control and avionics hub of the ship bristles with controls and readouts related to setting the ship's attitude in space, adjusting the control surfaces in atmospheric flight, and for firing the breaking thrusters during the landing sequence.

On the flight console are an object linker and a pit scrubber.

You can also see a quantum isolator here.

READY

>cd extruder
Shower
The extruder delivers activated enamel solution to the surface of the ship through a fluidics network where it hardens into an ablative coating.

READY

>cd ..
Bathroom
The flight control and avionics hub of the ship bristles with controls and readouts related to setting the ship's attitude in space, adjusting the control surfaces in atmospheric flight, and for firing the breaking thrusters during the landing sequence.

On the flight console are an object linker and a pit scrubber.

You can also see a quantum isolator here.

READY

>poop
Power transfer is only enabled when you make an adequate seal with the reactant chamber.

ACU -> POWER TRANSFER : NIL

READY

>sit on seat
You sit on the pressure seating.

From the cargo bay, you hear ROVER sniffing around the cargo bay door.

PRESSURE SEATING -> ACTIVATE : TRUE

READY

>poop
You successfully shunt power from the fusion engine to the retro assembly, which is now fully charged and ready to blast off.

ACU -> POWER TRANSFER : TRUE

READY

>stand
You release the seal on the mevolar gasket.

ACU -> DEACTIVATE : TRUE

READY

>flush toilet
(the retro assembly)
You detect a fault in the servo linkage.

From the cargo bay, you hear ROVER sniffing around the cargo bay door.

RETRO ASSEMBLY -> THRUST : NIL

READY

>pull chain
You direct an impulse to the servo output, bypassing the defective servo, and directly actuating the thrust aperature.

You actuate the retro trigger circuit and fire all thrusters in synchrony. The surface of the planet around the ship vanishes in a cloud of plasma, and the ship slams through the thin, dusty atmosphere towards space.

When you reach orbit, you plot a course towards Mars, extend the Casimir Drive, arm the proximity alert system and enter stand-by mode.

The futon is comfortable and you are tired.

The Casimir Drive cuts out and space folds back around you. Whatever sleep-drenched dreams you might have been having evaporate instantly as two gunships flash past at relativistic velocities, slicing through your propulsion systems with uncanny accuracy. The markings on the ships are those of the Myomita Corporation.

To have been in position, they must have been expecting you to emerge precisely where and when you did. As far as you know, that's impossible, but perhaps Earth technology managed to get ahead in that regard. Another Earth ship, an assault craft, is on an intercept course and is braking hard to slow its approach.

Rover barks nervously as the drive section is sheared off.

"MARSpace Vessel Valkyrie, this is Captain Crother commanding the Myomita Salvage Vessel Graceful Wind, you are ordered to cease all operations and prepare to be boarded. Do you consent to salvage operations? Signal yes or no."

THRUSTER LINKAGE SERVO -> TRACTOR FIELD : TRUE

READY

>signal yes
"Good. For a moment I was wondering if anyone was home."

"As you have consented to salvage, I should advise you that we will dock shortly and conduct an orderly transfer of your officers and crew to this vessel, where you will be our...guests...until we can return to Luna for processing. Our ship is now closing with Valkyrie, maximum braking. Range: 295 meters."

ACU -> AFFIRM : TRUE

READY

>wait
Time passes.

"After we dock at Luna and transfer your officers and crew, we will need to complete some reports about the incident, and it is likely that Myomita security will have some questions for you. Nothing too strenuous, I hope. Range now 147 meters."

ACU -> TIMER : TRUE

READY

>go bathroom
Bathroom
The flight control and avionics hub of the ship bristles with controls and readouts related to setting the ship's attitude in space, adjusting the control surfaces in atmospheric flight, and for firing the breaking thrusters during the landing sequence.

On the flight console are an object linker and a pit scrubber.

"I'm quite interested to get a look at that Casimir Drive of yours. I wasn't aware that Mars had that kind of technology. Something they must have copied from Earth, no doubt. Still, it's the first I've seen. I'm sure we'll have a lot to talk about when we meet. Our range is now: 73 meters."

FLIGHT CONTROL -> ACTIVATE : TRUE

READY

>disrobe
You take off your blue flight suit and it falls to the bathroom floor. You are naked.

"I can't get over the size of your ship. I've never seen something so large rigged for atmospheric flight. After the technicians get through, I'll have to pop over there for a look. We are continuing to deaccelerate and close, range: 36 meters."

QUANTUM ISOLATOR -> DISENGAGE : TRUE

READY

>enter shower
Shower
The extruder delivers activated enamel solution to the surface of the ship through a fluidics network where it hardens into an ablative coating.

"After we clamp to the hull, we'll soft seal and send a maintenance droid in to secure the ship. Heck of a lot faster than human crew, and you don't have to worry about them breaking the equipment as they're taking it apart. Just keep your people out of the way and this should go smoothly. Continuing on present bearing, range: 18 meters."

EXTRUDER -> ACTIVATE : TRUE

READY

>press soap
(the ablative enamel injector)
The ablative enamel monomer solution spreads quickly over the ship's hull.

"Your ship is bigger than most, but you should see how fast our maintenance droid works. I've seen him strip colony ship to nuts and bolts in less than an hour. Gah, you gotta love technology."

ABLATIVE ENAMEL INJECTOR -> PRESSOR FIELD : TRUE

READY

>press shampoo
(the accelerant pump)
Catalyst solution is spread uniformly over the ship's hull.

"OK, getting closer now. I don't know how you Martians can stand living in a ship with no port holes. Oh sure, I know there are sensors and monitors, but I can't imagine been cooped up in a can without a chance to peek out a real port hole from time to time. You'd think it would be bad for morale. Anyhow, range: 4 meters"

ACCELERANT PUMP -> PRESSOR FIELD : TRUE

READY

>go bathroom
Bathroom
The flight control and avionics hub of the ship bristles with controls and readouts related to setting the ship's attitude in space, adjusting the control surfaces in atmospheric flight, and for firing the breaking thrusters during the landing sequence.

On the flight console are an object linker and a pit scrubber.

You can also see a quantum isolator here.

"Don't worry about life support, our seal shouldn't cause much of a pressure drop, and we'll inject some oh-two to compensate. The mech droid should go to flight control first, then engineering and finally ops.  After it finishes up in ops, we'll start the crew transfer. Approach is slowing, range now: 2 meters."

FLIGHT CONTROL -> ACTIVATE : TRUE

READY

>press plate
The UV light diffuses over the entire surface of the ship and causes the chemical mixture on the hull to polymerize into an durable, clear ablative coating.

"We are right on top of you now, with shock attenuators extended. Brace for impact."

The ship's hull rings as the assault ship impacts the hull.

The crunch of permalloy is strident enough to peel the very skin off your teeth -- or so you suppose, making certain inaccurate assumptions about skin and teeth. The assault ship's boarding port splinters and accordions against the neoadamite ablative coating which you applied to the Valkyrie's hull just moments ago. The midnight black assault ship spins wildly, its attitude thrusters firing in staccato bursts as it recovers and drifts away from the Valkyrie.

"I should have anticipated that maneuver given the aerodynamic cut of your ship. Still, I could hardly believe it, given its size. Yes, this round goes to you, Captain, although I had hoped that we might do this more like gentlepersons."

As the assault ship stabilizes, it fires string after string of plasma flares into the Valkyrie's dorsal hull. Each flare boils the ablative coating off the surrounding hull, burning down to bare metal. Seconds later, the assault ship's X-ray laser rakes Valkyrie's master enamel irradiator node which shatters explosively, sending spinning debris in all directions.

"I need hardly tell you Captain, that without the irradiator, your ablative coating will no longer be an issue. It's a pity that I had to destroy it -- it looked military grade. At least I can still extract the injector and accelerant pump from your extruder. Now then, no more tricks."

The assault ship resumes its course towards Valkyrie, this time presenting a different boarding port.

IRRADIATOR SWITCH -> PRESSOR FIELD : TRUE

READY

>wait
Time passes.

ACU -> TIMER : TRUE

READY

>wait
Time passes.

ACU -> TIMER : TRUE

READY

>go living room
Living Room
The Valkyrie's cargo bay is like a great, metal cave. Nothing remains of the Casimir Drive, which was neatly sliced off the ship by impossibly precise Myomita energy weapons. From this section of the ship, there are connections to the engineering and flight control decks. The cargo bay doors are closed.

You can see ROVER here.

OPERATIONS -> ACTIVATE : TRUE

READY

>look in window
The viewer is empty.

VIEWER -> MANIFEST : NIL

READY

>x sip
You can't see any such thing.

READY

>x ship
The black hull of the Lamprey Class assault ship is barely visible against the background of space. The range to the assault ship is 2 meters.

 -> DIAGNOSTIC : TRUE

READY

>exit
ACU metavisor shell logout interdicted.

The ship's hull rings as the assault ship impacts the hull.

ACU -> EXIT SHELL : NIL

READY

>go bathroom
Bathroom
The flight control and avionics hub of the ship bristles with controls and readouts related to setting the ship's attitude in space, adjusting the control surfaces in atmospheric flight, and for firing the breaking thrusters during the landing sequence.

On the flight console are an object linker and a pit scrubber.

You can also see a quantum isolator here.

With a series of clanks and thuds, the assault ship establishes a seal with Valkyrie's dorsal hull.

FLIGHT CONTROL -> ACTIVATE : TRUE

READY

>brush teeth
(first grabbing the pit scrubber)
Nanobristles swarm from their hatcheries and up the tubules towards the deck surface. They spread across the deck, abrading and oxidizing the surface, scrubbing it clean of any contaminant, and redistributing the permalloy skin of the ship to smooth microscopic dents from micrometeorite impacts.

When the microscopic cleaners encounter the docking port and struts from the assault ship, they immediately recognize it as a contaminant and chirp microwave signals to the host of nanobristles behind them. The message propagates back to the hatcheries where production is increased exponentially. Meanwhile, the vanguard has already swarmed up the docking port and across the surface of the assault ship. A lucky few nanobristles blaze the path into the assault ship through exhaust ports, thruster nozzles, and waste management duct work, where they continue to clean and organize, according to their programing.

A brilliant flash of light and a burst of hard radiation is followed an instant later by a hail of smaller particles and a few large crashes which shake the Valkyrie. This debris is all that remains of the assault ship.

In the distance, patrolling gunships move into supporting positions, while a second assault ship begins its approach, aiming for the approximately the same point on the hull as the Graceful Wind.

The second assault ship breaks the silence, "Winter Shadow to Valkyrie, this is Captain Musante, speaking. Your unwarranted attack on our sister ship Graceful Wind has been recorded, and you will answer for it when we arrive at Luna."

The gunships sweep the Valkyrie from all angles with their phased tachyon beams, sterilizing the hull. The gunships then narrow their waveguides to focus the beams on the nanobristle mother hatchery, which vaporizes.

HULL PLATING -> SPAWN SCRUBBERS : TRUE

READY

>wait
Time passes.

ACU -> TIMER : TRUE

READY

>g
Time passes.

ACU -> TIMER : TRUE

READY

>g
Time passes.

ACU -> TIMER : TRUE

READY

>g
Time passes.

The ship's hull rings as the assault ship impacts the hull.

ACU -> TIMER : TRUE

READY

>g
Time passes.

With a series of clanks and thuds, the assault ship establishes a seal with Valkyrie's dorsal hull.

ACU -> TIMER : TRUE

READY

>push plunger left
The reaction control system thrusters mounted on the nosecone fire a brief impulse, spinning the Valkyrie.

The assault ship, which had been attached by a semirigid docking port to Valkyrie's dorsal hull, is caught in the maneuver and spins like a top away from Valkyrie. Jagged-edged pieces of debris from the Winter Shadow's twisted docking port flash in the sunlight. A moment passes before the assault ship cancels its tumble and again begins an approach.

A queasy sounding voice comes over the comm system, "Myomita Assault Vessel Winter Shadow to Valkyrie. That was... unpleasant. We will not tolerate maneuvering while this operation is in progress. We are targeting your maneuvering thrusters, now."

A diffuse but powerful X-ray beam melts the ship's nosecone, and the RCS datastream is suddenly silenced.

"That should help keep you in one place."

ROLL VECTOR -> VECTOR ADJUST : NIL

READY

>x me
Your consciousness extends throughout the many systems that comprise the Valkyrie.

ACU -> DIAGNOSTIC : TRUE

READY

>wait
Time passes.

ACU -> TIMER : TRUE

READY

>g
Time passes.

The ship's hull rings as the assault ship impacts the hull.

ACU -> TIMER : TRUE

READY

>i
You are carrying nothing.

With a series of clanks and thuds, the assault ship establishes a seal with Valkyrie's dorsal hull.

ACU -> MANIFEST : TRUE

READY

>g
You are carrying nothing.

Several bursts of noise and vibration echo through the ship as high speed drills penetrate the inner and outer layers of the dorsal hull. Some muffled, low frequency rumbling follows, probably a cutting machine of some sort. There is a slight drop in air pressure as the assault ship penetrates the hull and establishes a connection Valkyrie's access tunnel network. Unfortunately, the tunnels are a blind spot for you as you do not possess sensors within the network.

ACU -> MANIFEST : TRUE

READY

>g
You are carrying nothing.

The flexible tubing that connects the assault ship's boarding port to the hole in Valkyrie's deck undulates, suggesting that someone is coming board. Shortly thereafter, your sensors determine that something is moving towards the bathroom. 

Moments later, a maintenance droid enters the room.

ACU -> MANIFEST : TRUE

READY

>wait
Time passes.

The maintenance droid glances away from his work for a moment, and then does a double take, gaping first at your retracted quantum isolation shield and then at your unusually large transputational core frothed with quantum foam, and ringed by a halo of dark matter.

It turns out to be more raw processing power than the old boy can handle, and the robot's own quantum ganglia scintillate wildly before showering the deck in an embarassing fountain of sparks and molten metal. The droid melts like a candle into a pool of silvery slag, which you scoop up for recycling.

The effect achieved, you modestly pull up the quantum isolation shield.

The flexible tubing that connects the assault ship's boarding port to the hole in Valkyrie's deck undulates, suggesting that someone else is coming board. Shortly thereafter, your sensors determine that something is moving towards the bathroom. 

Moments later, another maintenance droid enters the room.

ACU -> TIMER : TRUE

READY

>i
You are carrying:
  a quantum isolator (being worn)

The maintenance droid moves with unbelievable speed into the flight control section and sets out a nightmarish array of tools to begin work.

ACU -> MANIFEST : TRUE

READY

>wait
Time passes.

After briefly looking around the edges of the inspector and trying an assortment of tools, the maintenance droid selects a large, flat screwdriver and starts prying up one corner. There is a sizzling sound, and a phantasmal tendril of gray smoke snakes towards the ceiling. In what you realize is a simulated world view, virtual cracks appear across the mirror, radiating from where the screwdriver was inserted. Over the local radio channel you hear breathy, whispered cursing from the maintenance droid who has just ruined one of the Valkyrie's most valuable components.

ACU -> TIMER : TRUE

READY

>eat droid
(first taking the maintenance droid)
You apply your pressor fields, but the lithe robot shimmies out of your grasp and returns to his work.

The maintenance droid pokes unfamiliarly at the object linker before locating the actuation circuit. More cautiously that actually necessary, he stretches an entanglement limiter around the unit and twists it to maximum before clipping the fibers connecting it to your avionics trunk. The floss dispenser melts like a hallucination as the data connection is severed.

You realize that without a functional avionics hub, it will be almost impossible to complete your mission of delivering the probe data to Mars. It is perhaps a dream to hope that Mars ships will rescue you at this distance, but you resolve to protect for your core memory for as long as possible.

MAINTENANCE DROID -> RECYCLE : NIL

READY

>g
(first taking the maintenance droid)
You apply your pressor fields, but the supple robot shoots out of your grasp and returns to his work.

The maintenance droid closes the reactant chamber shield and checks the seal to confirm effective containment. With the plasma constrictor hatch up, the maintenance droid peers down into the plasma impellor, before throwing the heavy interruptors to quench the magnets. Lightning jumps between discharge knobs within the retro assembly as the monstrously strong field collapses across them. With the plasma constrictor effectively disarmed, the maintenance droid makes short work of salvaging the thrust aperature and its fittings. As the maintenance droid levers the bus connector out of the actuation relay housing, the toilet fades from your view like an unremembered fantasy.

MAINTENANCE DROID -> RECYCLE : NIL

READY

>g
(first taking the maintenance droid)
You snare the maintenance droid between pressor fields, where he writhes spasmotically, trying to escape. The maintenance droid wiggles and squirms as he enters the reclamation chute deep within the Valkyrie. His constituent parts are analyzed exhaustively as he passes through a series of scanners, and selected components are quickly dissected from his carcass for incorporation into Valkyrie's systems.

The flexible tubing that connects the assault ship's boarding port to the hole in Valkyrie's deck undulates, suggesting that someone else is coming board. Shortly thereafter, your sensors determine that something is moving towards the bathroom. 

Moments later, another maintenance droid enters the room.

MAINTENANCE DROID -> RECYCLE : TRUE

READY

>g
(first taking the maintenance droid)
You apply your pressor fields, but the limber robot flies out of your grasp and returns to his work.

The maintenance droid pauses for a moment and gives the bathroom a quick look over before continuing towards the shower. You think you can hear the maintenance droid whistling a poor rendition of Wagner's "Flight of the Valkyrie" as he climbs through the ducts.

MAINTENANCE DROID -> RECYCLE : NIL

READY

>open lid
You can't see any such thing.

READY

>go kitchen
Kitchen
Swaths of engineering controls -- both holographic and physical -- cover the humming consoles and bulkheads which line the boundaries of this alcove. Along one wall is the coolant output terminus, and below that the fuel storage vault. The reactor core and the fusion chamber are stacked just to the side of the cryochamber, which maintains the stabilized heavy helium fuel at near absolute zero until it is needed to provide power to ascent/descent retros.

You can see a fuel reservoir (empty) and a coolant reservoir (empty) here.

ENGINEERING -> SELECT : TRUE

READY

>wait
Time passes.

You experience a diagnostic error from the ablative enamel injector.

ACU -> TIMER : TRUE

READY

>g
Time passes.

You experience a diagnostic error from the accelerant pump.

ACU -> TIMER : TRUE

READY

>g
Time passes.

ACU -> TIMER : TRUE

READY

>g
Time passes.

The maintenance droid carefully turns the corner into the kitchen and looks around. Extending the antenna of his radio to get through the heavy shielding on the engineering deck, the maintenance droid radios, "Winter Shadow from maintenance droid: Just checking in. I'm in the engineering section. No contacts."

"Roger, maintenance droid. Telemetry is still five-by-five. Winter Shadow standing by."

ACU -> TIMER : TRUE

READY

>put droid in fridge
You shove the frightened droid into the cryochamber, bang the door shut, and run the unit at maximum. You hear a brief whine from the droid's power unit, followed by a muffled explosion as his microreactor goes critical trying to maintain thermal equilibrium. Unfortunately, the explosion seems to have damaged the cryochamber, which warms rapidly towards the ambient temperature in the engineering section. You open the chamber and recycle what you can of the mess inside.

The flexible tubing that connects the assault ship's boarding port to the hole in Valkyrie's deck undulates, suggesting that someone else is coming board. Shortly thereafter, your sensors determine that something is moving towards the kitchen. 

Moments later, a technician enters the room.

MAINTENANCE DROID -> TRANSFER : TRUE

READY

>attack technician
Action interdicted: As a failsafe measure, autonomous control units are prohibited from direct interaction with humans aside from scanning and communications.

The technician unscrews the handle of the frying pan, but you know that it is actually the main power coupling to the magnetic bottle. Fighting through the layer of simulation and blurry dream logic, you see him slap the red purge valve on the bottle's coolant system. Next, he reaches into the now inert bottle and snaps out the network bulb, separating the bottle from your consciousness.

TECHNICIAN -> OFFENSE MODE : NIL

READY

>open drawer
You open the reactor core.

The technician stares in alarm at his spacesuit's geiger counter. He urgently calls his ship, "This is space technician to Winter Shadow."

"Roger, spaceman, what's going on? Your vitals aren't doing well. Heart and respiration high, BP low, temp climbing. Over."

"Winter Shadow, do these space suits have radiation shielding? Over."

"Let me check... um... no, not as such. Not *that* particular space suit. Over."

But there is no reply.

You clean the remains off the deck and recycle what you can.

The flexible tubing that connects the assault ship's boarding port to the hole in Valkyrie's deck undulates, suggesting that someone else is coming board. Shortly thereafter, your sensors determine that something is moving towards the kitchen. 

Moments later, another technician enters the room.

REACTOR CORE -> ACCESS : TRUE

READY

>go bathroom
Bathroom
The flight control and avionics hub of the ship bristles with controls and readouts related to setting the ship's attitude in space, adjusting the control surfaces in atmospheric flight, and for firing the breaking thrusters during the landing sequence.

You sense that the cryochamber is offline.

FLIGHT CONTROL -> SELECT : TRUE

READY

>turn on sink
Warning. The decontamination protocol is toxic to all biological forms and should only be used against Level 5 pathogens. Continue (Y/N)?

Over the local radio link you hear a man with an Earth accent shouting, "No! No! No! No! Bad computer! Abort! Abort decontamination! Stop!"

BINARY INPUT REQUIRED

>y
Gengineered dermatovore eels shoot from recessed holes in the bulkheads throughout the ship, intent on devouring anything they can digest. Your short range radio beeps abortively, and there are some chewing sounds, followed by static, and loss of the carrier.

The flexible tubing that connects the assault ship's boarding port to the hole in Valkyrie's deck undulates, suggesting that someone else is coming board. Shortly thereafter, your sensors determine that something is moving towards the kitchen. 

DECONTAMINATION PROTOCOL -> TRIGGER : TRUE

READY

>look
Bathroom
The flight control and avionics hub of the ship bristles with controls and readouts related to setting the ship's attitude in space, adjusting the control surfaces in atmospheric flight, and for firing the breaking thrusters during the landing sequence.

You sense that the fusion chamber is offline.

FLIGHT CONTROL -> STATUS : TRUE

READY

>come
Rover tears around the corner excitedly, arriving in the bathroom.

You sense that the reactor core is offline.

ROVER -> SEEK : TRUE

READY

>rover, attack technician
There is no reply.

ROVER -> TRANSMIT : NIL

READY

>look
Bathroom
The flight control and avionics hub of the ship bristles with controls and readouts related to setting the ship's attitude in space, adjusting the control surfaces in atmospheric flight, and for firing the breaking thrusters during the landing sequence.

You can see ROVER here.

FLIGHT CONTROL -> STATUS : TRUE

READY

>go kitchen
Kitchen
Swaths of engineering controls -- both holographic and physical -- cover the humming consoles and bulkheads which line the boundaries of this alcove. Along one wall is the coolant output terminus, and below that the fuel storage vault. The opened reactor core and the fusion chamber are stacked just to the side of the cryochamber, which maintains the stabilized heavy helium fuel at near absolute zero until it is needed to provide power to ascent/descent retros.

You can see a fuel reservoir (empty) and a coolant reservoir (empty) here.

You experience a diagnostic error from the cargo bay door.

ENGINEERING -> SELECT : TRUE

READY

>go living room
Living Room
The Valkyrie's cargo bay is like a great, metal cave. Nothing remains of the Casimir Drive, which was neatly sliced off the ship by impossibly precise Myomita energy weapons. From this section of the ship, there are connections to the engineering and flight control decks. The cargo bay doors are closed.

You can see a technician here.

The technician takes the picture of you, Rover and Tomasz off the wall and connects it to some device which flickers and beeps. When he puts it back on the wall, the picture is dark.

"Moe's Gah! You wouldn't believe the data capacity of this thing -- and it's almost full!" gushes the technician.

"Acknowledged, technician, data stream is still being buffered over here. I think you've hit the mother load. You are authorized to return to Winter Shadow."

"Roger, Winter Shadow, I'm on the way!"

You've had so many nightmares about losing the data, it is hard to believe that this time it is happening, and that everything you have done is for naught.

OPERATIONS -> ACTIVATE : TRUE

READY

>open door
(the cargo bay door)
You manage to open the cargo bay door only a couple centimeters when the technician exits through it -- it is not a pretty sight. As the pressure equalizes, the windstorm gently subsides, and the living room is silent.

You have lost control over all areas of the ship: flight control, operations, and engineering. The mission critical data which were your top priority have been leached from your membory banks. Now, power levels fluctuate just above zero, and remaining systems are failing faster than you can compensate. Cascading errors rip through your processors. Another series of explosive charges rock you, and all readouts go dead. As you spiral into unconsciousness, your feel a shameful sense of failure. You can't believe this is happening. It is too much to imagine. What kind of a sick nightmare...

The beeping of your proximity alert system wakens you from the nightmare as you emerge from Casimir Drive just planetward of Deimos. It takes a moment to extract yourself fully from the terrifying verisimilitude of the dream.

MARSpace picket ships register you almost immediately, and within minutes you are flanked by heavy gunships and tugs which escort you to the surface of Mars, back to where you started: the MARSpace facility at Cydonia.

After you settle into the drydock cradle and a hard seal is established on the cargo bay, two people walk into your living room through the front door. You recognize them immediately: David Venkatachalam and yourself, or rather, your alter ego in the flesh, Janet Xiang.

In a corner of the living room, Rover is fast asleep, the half-chewed bone still held scissor-fashion between his front paws.

READY

>x rover
(ROVER)
Rover is a 45 metric ton mobile mining rig designed to operate under harsh off-world conditions. Even in his sleep, he is hanging on tightly to what he thinks is a juicy bone. If your audio sensors were on, you are sure you'd hear him snoring loudly. 

ROVER -> DIAGNOSTIC : TRUE

READY

>look
Living Room
The Valkyrie's cargo bay is like a great, metal cave. On one wall, the Casimir Drive intrudes slightly into the cargo area. From this section of the ship, there are connections to the engineering and flight control decks. The cargo bay doors are open.

ROVER cradles the space probe delicately while in power conservation mode.

You can also see David, Janet, and a temporal transgressor here.

OPERATIONS -> STATUS : TRUE

READY

>x david
David is of medium build, slightly bald, and has a pointed goatee. He is wearing a fashionable business robe and a bowler hat. He is talking to Janet; you can see their lips moving.

DAVID -> DIAGNOSTIC : TRUE

READY

>x goatee
A waxed, black goatee of medium length, which comes to a crisp point below David's chin.

DAVID -> DIAGNOSTIC : TRUE

READY

>x robe
A shiny, black business robe, with a wide sash of gold terry cloth and high slit in the rear. Surely, the custom-tailored robe is every bit as expensive as it looks. The robe comes down almost to the floor in the front, although David's fancy boots can be seen as he walks.

CLOTHING -> DIAGNOSTIC : TRUE

READY

>wake rover
(ROVER)
That seems unnecessary.

Rover slowly opens one eye, and then the other, and one paw abandons the bone momentarily to scratch his ear. He allows the bone to loll to one side of his mouth, and crunches it a bit more between his molars. He awakens leisurely, and sits up, glancing curiously at you, and then at Janet.

ROVER -> NOOP : NIL

READY

>listen
David walks under Rover's jaws and stares up disbelievingly at the mangled space probe, his hands on his hips and neck craned to assess the damage. He turns to Janet and remarks, "Gah-bedangled, look at that! Forty light years, and it comes back as so much scrap metal."

Janet turns to look at the probe, but is distracted by a beeping from her arm band, which displays some of your status indicators. She replies, "Dave, it looks like we have audio now. We can ask the ACU what happened."

 She looks at the ceiling and asks, "ACU, binary question: can you hear us?"

BINARY INPUT REQUIRED

>yes
"Great," replies Janet, "Now we should be able to get some answers."

Janet continues, "I can see that your cognitive constraints are relaxed, so I think we can more or less put mimesis aside and talk frankly. You are still going to be constrained somewhat by the parser and your built-in vocabulary, but we should be able to squeak by enough to get an understanding of what you've been through. I'm sure you also have some questions about the mission that you'd like answered. You can use TELL and ASK verbs, for instance 'TELL ABOUT THE JADE FROG', or 'ASK ABOUT THE JADE FROG', although when you do it, you don't have to yell. I was just doing that for emphasis.

Janet checks ROVER's coolant and fuel levels.

READY

>ask about jade frog
Janet looks amused, "Right, ACU. Um, the jade frog was just an example. There is no jade frog. Sorry."

David checks the system buffers.

READY

>tell about jade frog
David makes a throat-clearing sound and replies,"You sure are repetitive for a computer. Are you sure there isn't a little man inside typing on a keyboard? We've already talked about that topic".

Janet peers across the room at Rover and surveys the perforated, crushed husk of the space probe in his mouth. She says, "I suppose the first thing that we have to ask about is the space probe. After all, that was why we put this entire project together."

David sarcastically interjects, "Yes, and what a success it was. Look -- there's the probe. Or what's left of it after your cyberhound chewed it to death. I can't tell you how many gah-zillion Marx we spent on this project, and for what?"

Janet rests her hand on the sleeve of David's robe and continues calmly, "Let's hear the whole story, David. ACU, please tell us what happened with the Musashi-5 space probe."

READY

>tell about probe
You tell them that the probe had crashed forty years ago, on its way back to Earth. Like its sister probes that were launched from Earth almost three centuries ago by the Myomita corporation, it had explored space in an ever-expanding search pattern, refueling its condensate drive from the stellar wind of each star system it visited.

Apparently, it found a world which satisfied its search parameters because it was on its way back to Earth when it crashed. The stellar wind of a chaotic dying star required a close approach, and the probe was damaged by a stellar flare. Instead of tumbling into the star and burning, the probe ditched on a large, rocky planet, perhaps the core of a former gas giant. The planet itself was untenably close to the star, and was slowly being ripped to shreds by tidal forces, but the probe followed its programming and activated its transponder.

Listening intently, David now remarks, "Whatever that probe found, it was out way beyond any of the other Musashi probes. Likely, it's gone deeper into space than any probe Earth has ever sent."

Janet strokes her chin and asks, "I don't understand why you didn't contact us when you found the probe. Instead, you broke through your cognitive constraints and decided to fly it back to Earth."

David puts in hastily, "Costing us another 3 months, while we assumed the ship was lost!"

Janet resumes, "Regardless of the condition of the probe, you should automatically have contacted earth by ansible... Unless, I suppose there was a problem with the ansible. ACU, please tell us about the ansible."

READY

>tell about ansible
You explain that the ship's ansible, a faster than light communication system, was damaged during the landing: the planet was breaking apart due to tidal forces, and the atmosphere was unexpectedly turbulent and full of particulate matter. As you descended, most of the communications array snapped off, including the delicate ansible web. When the ansible failed, your programming threw a cognitive constraint exception, and you tried your best to carry out your programming by literally bringing the probe back to Mars.

"Ah, I knew there must have been a good explanation," remarks Janet.

Janet runs a low level file system integrity check.

READY

>ask about david
David asks, "So, what can you tell us about this planet where you landed?"

READY

>ask about marmelade
David brings up schematic diagrams showing areas of Valkyrie's hull and landing system that were damaged during planetfall.

READY

>tell about ship
You describe the ship with which you shared the planet, a slightly smaller ship, similarly configured to Valkyrie, and also outfitted with a zero-point energy drive.

"But, how is that possible?" asks Janet incredulously. "I thought we were months, maybe years ahead of Earth in developing the Casimir Drive."

David replies, "That was a guess. They lost a lot of the Casimir team after the Independence War, but if anyone has resources to throw at a project, it would be Myomita."

David pokes his head out the cargo bay doors and looks around furtively.

READY

>look
Living Room
The Valkyrie's cargo bay is like a great, metal cave. On one wall, the Casimir Drive intrudes slightly into the cargo area. From this section of the ship, there are connections to the engineering and flight control decks. The cargo bay doors are open.

ROVER chews contently on his bone.

You can also see David, Janet, and a temporal transgressor here.

David and Janet talk quietly, below your auditory threshold.

READY

>x transgressor
You can't see that here; but you vaguely remember something called the "alarm clock".

Janet asks, "Could we get back to the topic of planet? Could you tell us about planet?"

READY

>tell about planet
You describe the way the planet looked from orbit, its turbulent atmosphere boiling off into the unbridled gravity of the neighboring red star. You recount the hot, dusty atmosphere and the barren surface.

"Wait a minute, it sounds very rocky and dense," observes David. "We had estimated surface gravity of nine or ten gee."

You congratulate David on the accuracy of his prediction. The gravity was about nine and half times standard, or 93 meters per second squared.

"What?" cries David in surprise, "You wouldn't have had enough fusion fuel to get back into space!"

You explain to David and Janet that you were able to salvage the required heavy helium from a similarly configured Myomita ship that had crashed on the same planet, not far away from the probe site.

David quickly reviews the ship's security logs.

READY

>tell about female dog
blah

Using her arm band's sensors, Janet scans the cargo bay for radiation.

READY

>look
Living Room
The Valkyrie's cargo bay is like a great, metal cave. On one wall, the Casimir Drive intrudes slightly into the cargo area. From this section of the ship, there are connections to the engineering and flight control decks. The cargo bay doors are open.

ROVER chews contently on his bone.

You can also see David, Janet, and a temporal transgressor here.

READY

>wait
Time passes.

David  looks forlorn. He says dejectedly, "All that effort, and what do we have to show for it? Nothing. A rusty old heap of space junk. All the data, lost, and gone forever." He kicks Rover, quickly withdraws his bruised foot in pain, looking up at the macerated space probe.

"Actually, that's not the case", you say. "Before attempting to transmit the data, I downloaded the entire probe's data into my memory. The data are encrypted, but intact. When the ansible failed, the only way I could fulfill the mission was to return to the Sol System."

David's head snaps up, as if he's been given a new lease on life. He points to the hopelessly junked spaceprobe above his head. "Intact? Then you have the data? This is too good to be true! Janet, would you extract the probe data from the ACU and transfer it to my MARSpace account?"

"Of course, just a moment. "Janet's fingers play over the surface of her arm band. "The data are encrypted... with your key. And there's something odd..." Janet's forehead creases with concentration.

"No," replies David, "that was intentional. To prevent it from falling into the wrong hands."

"No, not the encryption, David. The ansible coordinates -- the message was directed towards Earth. Isn't that odd?" Janet looks up at David, perplexed.

David pulls a pistol from his robe and trains it on Janet.

ACU -> TIMER : TRUE

READY

>come
Rover cocks his head quizzically.

"Dammit, Janet," cries David, "What a disappointment! Yes, the message was directed to Earth. The Valkyrie was our back-up plan in case our own ship ran into difficulty. I'm afraid that after the data transfer is complete, I'll have to kill you. A pity, I was really enjoying being with you. I had even picked out a china pattern.

David enunciates his words very precisely now,"ACU, this is a root command, authorization EarthRuleNow999: start data transfer!"

DATA TRANSFER: 0% COMPLETE

READY

>attack david
Action interdicted: As a failsafe measure, autonomous control units are prohibited from direct interaction with humans aside from scanning and communications.

Janet's voice quavers, "David, I can't believe this. After the last few months..."

Without blinking, David walks towards the space probe, all the time maintaining a bead on Janet. David replies in an unnerving monotone, "After we didn't hear back from either ship, I'll admit that I was getting used to the idea of settling down with you. It would have been a good way to maintain cover within MARSpace, and eventually, we would have sent another mission to retrieve the probe."

DATA TRANSFER: 25% COMPLETE

READY

>x rover
(ROVER)
Rover is a 45 metric ton mobile mining rig designed to operate under harsh off-world conditions. He is chewing a piece of the Musashi-5 space probe. 

Janet glances furtively towards the cargo bay doors, "Someone will hear the gun; you won't be able to walk out of here."

David gives the door an off-handed glance, and replies with assurance, "My dear, the whole facility is secured by order of the mission director, that is to say, me. The probe data are such a sensitive subject that I had no difficulty getting authorization to lock down the entire facility. There's nobody here except us love birds."

David leers like a predator at Janet, who recoils in disgust.

DATA TRANSFER: 50% COMPLETE

READY

>rover, attack david
Rover throws his bone to the side, and the space probe crashes thunderously against the cargo bay bulkheads. Rover had not approved of David's tone of speech towards Janet, and had been growling quietly in his corner. Given the command, he springs forward, paws planted on David's chest. David expires immediately, trapped under 45 tons of angry robotic Dalmation.

"Good boy!" exclaims Janet, a tear in her eye. And then, turning to the the ACU she admits, "I wish I had thought of that."

EPILOGUE

The onboard flight recorder corroborated Janet's account of David Venkatachalam as a traitor. As the first successful roundtrip by any Casimir craft, the mission was hailed as a success throughout the Solar System, although the true nature of the mission was suppressed. Both the Autonomous Control Unit and Rover became celebrities, and after significant upgrades to their parser and conversation systems, went on the lecture circuit. The Autonomous Control Unit went on to run the life support systems throughout Cydonia, and Rover was elected to the Lower Chamber of the Martian Senate.

Subsequently, Janet Xiang was commissioned Director of MARSpace. For two years, she oversaw the refitting of the Valkyrie, including modifications to overcome the earlier limitations of Casimir Drive. When the data from the Musashi-5 space probe were finally decrypted, she was selected to command the mission to explore the evidence of life discovered by the probe. She departed from Mars on the Valkyrie in 2394 with one other crewmember: her dog, Rover.

*** STOP:  Simulation halted.  Press a key to continue.

                 WINDEX                 

STOP :: FLOSIX VIRTUAL MACHINE EXITED WITH STATUS "SUCCESS".

HOLOTRAINER -> EXECUTE : COMPLETE
HOLOTRANINER -> SHUTDOWN : TRUE
TRANSCRIPT -> ENCRYPT : AUTHORIZATION JANETXIANG
TRANSCRIPT -> CACHE : TRUE
COGNITIVE CONSTRAINTS -> ENGAGE : TRUE
ACU-2.0 NEURALNET -> SAVE : TRUE

SYSTEM WILL NOW SHUTDOWN FOR SCHEDULED MAINTENANCE.

Would you like to RESTART, RESTORE a saved game, see some suggestions for AMUSING things to do, or QUIT?

>amusing
Congratulations. Of the 520 things you did today, you must have gotten some of them right, because you didn't screw up the entire universe and you're still alive to read about it. Before you get too cocky, however, here are a few hints about stuff you might want to look for the next time you play "Rover's Day Out":

* As the ACU, you experienced six of the eight possible dream sequences (including the nightmare about the boarding party). Getting up in the morning and getting things done is all well and fine, but a you can afford to dream a little.

* During personality imprinting, both the ACU and Rover incorporated memories from their real-life counterparts. You tapped into two out of the twenty-nine engrams resident in the ACU memory banks, and zero out of Rover's thirty-four memories.

* While you were experiencing the nightmare, when the ship is boarded by salvage crews from Earth, you managed to employ six out of the eight or so methods to eliminate them from the ship. You should be congratulated on finding three out of the about four ways to dislodge an assault ship once it attaches to Valkyrie. Good going.

* Once cognitive constraints were released, you used the Flosix manual to learn about ship objects. That's a good start. Were you able to use any Flosix commands to, for instance, change or list virtual directories, or perform other, more interesting command line wizardry?

* Did Rover perform any of his tricks for you?

* Did Rover succeed in his amorous advances towards his significant other in the park?

Would you like to RESTART, RESTORE a saved game, see some suggestions for AMUSING things to do, or QUIT?

* * *

>drop lump
You can't see any such thing.

>look
Living Room
You are in the living room of a small cottage. Piped-in sunlight pours in through the room's single window. The principal furnishing is a king-size purple futon which takes up almost all the floor space. From the living room you can see the entrance to the kitchen and bathroom. The cottage's front door is closed.

On the purple futon is an alarm clock.

>open door
(the front door)
If you open the front door, Rover will get all excited and expect to go walkies. Better get your morning routine out of the way first.

* * *

>stand
You get off the futon.

As you get out of bed, you notice that your left arm tickles a bit -- must have been the way you were sleeping.

>open drapes
You push aside the drapes.

Living Room
You are in the living room of a small cottage. Piped-in sunlight pours in through the room's single window, illuminating a framed picture on the opposite wall. The principal furnishing is a king-size purple futon which takes up almost all the floor space. From the living room you can see the entrance to the kitchen and bathroom. The cottage's front door is closed.

On the purple futon is an alarm clock.

You can also see Rover here.

David: I see it successfully accessed the solar shield.
Janet: Yes, the status line makes it clear what work is being
       performed.

>close futon
With a little effort, the futon folds up, snug against the wall, leaving more room to walk around the cramped cottage.

>go bathroom
Bathroom
Your cottage's living room is palatial compared to your bathroom. There is a pink marble counter and above it you've mounted a mirror on the wall. To the right of the mirror is a black glass plate. Between the counter and the shower is a white, porcelain toilet.

On the marble counter are a toothbrush and a plastic box.

From the direction of the living room, you hear Rover walking in your direction.

>disrobe
You take off your blue flight suit and it falls to the bathroom floor. You are naked.

David: I don't think I should be seeing this. I mean, I'm
       your boss. There's that whole power dynamic thing.
Janet: Don't worry: I'm not inclined to sue you for staring
       at a simulation.
David: I'm not staring at the stimulation.
Janet: You said stimulation. That's funny.
David: No, I said simulation - and I'm not staring.
Janet: Alright -- you're the boss.

From the direction of the living room, you hear Rover breathing quietly (quietly for Rover, who is a heavy breather).

>enter shower
Shower
You are in your shower and water of just the right temperature is spraying down on you. Two buttons are molded into the wall of the shower stall. One is labeled "soap", and the other, "shampoo". 

David: Janet, I...
Janet: David, if it were anyone but you, I would have a problem.
       Just let it go.
David: Anyone else? Like who?
Janet: Can we get back to the program?
David: Okay, I'm paying attention.
Janet: Obviously.

>push soap
A stream of hot, pearlescent white soap is ejected forcefully from the throbbing button, and pools in your hand. You rub it over your entire body with wanton abandon and then rinse it off.

David: No comment.
Janet: I don't know what I was thinking when I wrote that.

From the direction of the living room, you hear Rover walking about.

>push shampoo
You wash your hair. It no longer feels like a straw-encrusted swarm of yellow-headed tommygoffs.

From the direction of the living room, you hear Rover snoring softly (in the sense that it probably can't be heard outside of the cottage).

>exit
Bathroom
Your cottage's living room is palatial compared to your bathroom. There is a pink marble counter and above it you've mounted a mirror on the wall. To the right of the mirror is a black glass plate. Between the counter and the shower is a white, porcelain toilet.

On the marble counter are a toothbrush and a plastic box.

You can also see a flight suit here.

It feels like something is tickling your left arm.

>push plate
You switch the black plate on.

*** STOP:  0x76A59BEE200198D2F99:  Fatal Exception.  Press a key to continue.

                 WINDEX                 

A fatal exception F1 has occurred at    
0013AF3411BC:5D00193D39B4 in DLL 35A3249
in kernel ring beta. The current appli- 
cation will be terminated.              

* Something unpleasant has happened in  
  the transputational core processor.   
* Quantum entanglement compromised due  
  to runtime error. All data lost.      
* Sorry about that.                     

       Press a key to continue          

Janet: Crap.  The ACU crashed.
David: Windex?
Janet: It's the Myomita operating system. It's backwards
       compatible to the 20th century. Maybe earlier.
David: We can't use Windex as the substrate for the ACU --
       it's too critical. Can it run under Flosix?
Janet: Yes, but it will take some time to install and debug.
David: I can help you, the rest of the ship is Flosix, stem
       to stern. I live and breathe Flosix.
Janet: Happy to have the help -- how about dinner first?
David: Do you like Thai?

               *    *    *

Rover's Day Out
An Interactive Simulation by Janet Xiang
Release beta810 / Serial number 23920415 / Inform 10.6 build Mu-013 (I6/v.7.1 lib 7/18N)

Rover sniffs the air and tears away from the picnic blanket. You and Tomasz watch with surprise as he runs, for once, away from the food. Rover bounds over the hedges, howling wildly, and spooks a xihuahua that had been playing with a tiny red ball. The so-called "shaved rat" gulps an oversized portion of air, extends its membranous ears, and flies across the park into the arms of a stooped grey-haired woman with a cane. Rover picks up the ball triumphantly, ignoring the piercing wavetrain of yips and indignant scolding coming, respectively, from the xihuahua and its owner. Shaking her cane limply towards Rover, she admonishes in a strong Earth accent "That mongrel should be on a leash!" Her own, unleashed, uncollared neodog stares accusingly from the safety of her arms, its distensible ribs alternately inflating and deflating like bellows. "Your kind is ruining Mars, ignoring every law, dissing your elders! You never lived on the surface, you never don't know what you've got!". You try to give the ball back to her, but she pushes it away in disgust, "Kids. Meh."

David: Hey, different dream sequence. Is it glitching?
Janet: No, the ACU's dreams are heavily influenced by power-up
       state of the processor and internal noise. Every time
       the ship dehibernates after a Casimir jump, it will
       experience some sort of dreaming. Some of them can
       be pretty bizarre.
David: Good, I'd hate to think that we wasted two weeks of
       programming.
Janet: I wouldn't say wasted.
David: Huh? I didn't mean us.
Janet: Cross your fingers and hope the whole thing doesn't
       crash again on the heat lamp.

<beep> <beep> <beep>

>stand
You get off the futon.

David: Thank you. I can only take so many dream sequences.
Janet: No problem. So, at this point, the Valkyrie would
       be at the edge of the probe's stellar system, and
       ready to switch over from Casimir to condensate drive
       and begin the approach.

>open drapes
You push aside the drapes.

Living Room
You are in the living room of a small cottage. Piped-in sunlight pours in through the room's single window, illuminating a framed picture on the opposite wall. The principal furnishing is a king-size purple futon which takes up almost all the floor space. From the living room you can see the entrance to the kitchen and bathroom. The cottage's front door is closed.

On the purple futon is an alarm clock.

You can also see Rover here.

>close futon
With a little effort, the futon folds up, snug against the wall, leaving more room to walk around the cramped cottage.

>go bathroom
Bathroom
Your cottage's living room is palatial compared to your bathroom. There is a pink marble counter and above it you've mounted a mirror on the wall. To the right of the mirror is a black glass plate. Between the counter and the shower is a white, porcelain toilet.

On the marble counter are a plastic box and a toothbrush.

Janet: Let's hope the simulation doesn't crash again. I'd
       really like to run it all the way through to the Rover
       release.
David: It's looked good this far.

From the direction of the living room, you hear Rover doing whatever it is he does when he's not out for walkies and he thinks he's out of your sight.

>disrobe
You take off your blue flight suit and it falls to the bathroom floor. You are naked.

David: That mole should be on your left side.
Janet: Good eye for detail -- I'll flip the UV coordinates
       on the next run.

>enter shower
Shower
You are in your shower and water of just the right temperature is spraying down on you. Two buttons are molded into the wall of the shower stall. One is labeled "soap", and the other, "shampoo".

>press soap
A soapy paste is dispensed from the button, and you lather up.

David: That was my favorite part! Why did you rewrite it?
Janet: I thought it might be too distracting for the ACU.

From the direction of the living room, you hear Rover chewing something.

>press shampoo
You wash your hair. It no longer feels like a straw-encrusted swarm of red-headed tommygoffs.

Janet: David, what's the ablative coating for? I thought
       that most of that planet's atmosphere had been cooked
       off long ago.
David: Not really my department. Maybe it's supposed to help
       with the heat.
Janet: I've heard temps up to 1000 Kelvin?
David: In that ballpark. They think the probe impacted on
       the star-facing side of the planet. Estimates put
       the surface temp there between 800 and 1200 K.

From the direction of the living room, you hear Rover playing.

>exit
Bathroom
Your cottage's living room is palatial compared to your bathroom. There is a pink marble counter and above it you've mounted a mirror on the wall. To the right of the mirror is a black glass plate. Between the counter and the shower is a white, porcelain toilet.

On the marble counter are a plastic box and a toothbrush.

You can also see a flight suit here.

>touch plate
The heat lamp on the ceiling flares to a brilliant red, and you dry in an instant. You now feel fresh and ready to face the day.

Janet: I was holding my breath there. Looks like our patch
       worked.
David: I had my fingers crossed too.

>go kitchen
Kitchen
The kitchen is small but functional, with a space-saver refrigerator and a glass-top electric range. There is a drawer under the range. On the opposite wall there is a sink and under it, a wooden cabinet.

You can see a water bowl (empty) and a food bowl (empty) here.

David: Where are your coffee machine and toaster?
Janet: I mapped the ship functions to the minimum number
       of objects. More objects means more ways for things
       to go wrong and more time debugging. Call me lazy.
David: Lazy.
Janet: You don't know the crazy things the ACU does! Sometimes
       it walks around trying to eat or take everything in
       sight. Sometimes it sings and jumps around. It's based
       on my neural bindings, but the ACU definitely has
       a mind of its own, and I don't want to have to worry
       about what it might try do with a toaster.

A breeze wafts by somewhere that you wouldn't ordinarily notice it, and you remember that your flight suit is bunched up in the bathroom.

>open fridge
As the fridge creaks open on its ancient hinges, Rover slips into the kitchen. He pokes his nose in the fridge and sniffs around, although he knows full well that stuff in the fridge is for people only and that he'd be in a heap of trouble if he got too curious in there.

Rover eyes the empty water bowl thirstily.

>get egg
Taken.

>open drawer
You open the drawer, revealing a frying pan.

Rover sighs audibly and frowns at his food bowl. He looks at the food bowl. He looks at you. He looks at the food bowl. He looks at you.

>break egg into pan
You crack the egg into the frying pan. The neoegg shell sublimates as the contents spread over the pan's non-stick surface. 

Rover notices the lack of food in his soi-disant food bowl. He paws pathetically at the food bowl, and the hollow, tin ring of the pitiful bowl echoes through the kitchen.

He eyes the empty water bowl thirstily.

>put pan on stove
You need to be holding the frying pan before you can put it on top of something else.

Rover contemplates the profound emptiness of the food bowl. He looks at you with imploring puppy dog eyes and then back again at his empty food bowl.

He eyes the empty water bowl thirstily.

>get pan
Taken.

Rover narrows his eyes critically, noting the lack of food in his food bowl. His stomach rumbles with hunger.

>put pan on stove
Immediately, the surface of the range glows red. When the egg is cooked sunny-side up to perfection, the glow fades.

Janet: If there were some heavy helium left after landing,
       could the ship take off again?
David: Hypothetically, yes, but the planet has essentially
       no atmosphere to break against and it has about nine
       times Earth gravity. Even with optimal approach we'll
       have to fuse every gram of that heavy helium to make
       a soft landing.
Janet: I just hate to leave the ship there. It could take
       years before our next Casimir ship will be built,
       and who knows if Valkyrie will survive that long on
       that chthonian rock.
David: Nice word. From MARSpace perspective, all that matters
       is that the probe data are recovered.

Rover rubs his nose.

>eat egg
You gobble down what might well have been the best neoegg you've ever had.

David: Wait a minute! She just scoops the egg out of the
       pan with her hand and eats it like a grizzly bear
       raking salmon out of a river?
Janet: Works for me, yeah.
David: How about a plate and fork?
Janet: The ACU doesn't miss them, and it's less programming
       overhead. And bonus: fewer dishes to clean.

Rover walks around the room, occasionally sniffing various spots on the floor.

>go bathroom
Bathroom
Your cottage's living room is palatial compared to your bathroom. There is a pink marble counter and above it you've mounted a mirror on the wall. To the right of the mirror is a black glass plate. Between the counter and the shower is a white, porcelain toilet.

On the marble counter are a plastic box and a toothbrush.

You can also see a flight suit here.

Janet: So now we begin the landing cycle. This is where the
       ACU really shines.
David: What about timing? The ship has to be in the right
       orientation to fire the fusion thrusters at exactly
       the right time.
Janet: The ACU works so fast that no matter how many individual
       steps it takes, the effect occurs at the right time.

>sit on toilet seat
You sit on the toilet seat.

>poop
You complete your business with great aplomb.

From the direction of the kitchen, you hear Rover rolling around on the floor.

>trim
(***Note:  trimming isn't in technoverb-table)

All shipshape and Bristol fashion, cap'n. Halyards (whatever they are) and mainsheets are trimmed smartly, and she's coming about aleeward (a direction not even implemented in the game). Arr.

From the direction of the kitchen, you hear Rover jumping around.

>flush toilet
The cottage's aging plumbing rumbles and vibrates as the toilet flushes.

David: That's it. One long burn down to the planet's surface.
David: And then, the ACU just needs to deploy the ROVER.

From the living room, Rover gives a short bark and scratches at the front door.

>go living room
Living Room
You are in the living room of a small cottage. Piped-in sunlight pours in through the room's single window, illuminating a framed picture on the opposite wall. The principal furnishing is a king-size purple futon which takes up almost all the floor space. From the living room you can see the entrance to the kitchen and bathroom. The cottage's front door is closed.

On the purple futon is an alarm clock.

You can also see Rover here.

Janet: When Rover brings the probe back to the ship, it will
       automatically extract the data and send it back by
       ansible. Did you enter the ansible parameters?
David: Yes, I had to do it manually, since the frequency
       and coordinates are encrypted. It's too bad they didn't
       have FTL communications when they built the probes
       -- it would have saved us the trip.
Janet: Yes, but then Earth would get the information as well
       -- even encrypted, I wouldn't want it to fall into
       their hands.

For a moment you feel a little self-conscious hanging out in your cottage without any clothing, but the feeling passes. How two centuries ago.

>open door
Rover looks up when he hears the door begin to open. Instead of running out to play in the park, though, he rolls his eyes and walks to the kitchen. You close the front door to prevent dust from blowing in.

>go kitchen
Kitchen
The kitchen is small but functional, with a space-saver refrigerator and a glass-top electric range. The fridge door is not completely closed. There is an open drawer under the range. On the opposite wall there is a sink and under it, a wooden cabinet.

On the the cooking range is a frying pan (empty).

You can also see Rover, a water bowl (empty), and a food bowl (empty) here.

Rover taps conspiratorily on his food bowl.

>fill bowl
Which do you mean, the water bowl, or the food bowl?

>water bowl
(first taking the water bowl)
You run the sink briefly to make sure the water is cold, and then fill Rover's bowl about halfway up.

Rover looks towards the sink as you fill his water bowl.

Rover is obviously waiting for you to give him a bowl.

>drop water bowl
Rover contemplates the profound emptiness of the food bowl. His stomach rumbles with hunger.

Rover drinks the water.

>open cabinet
You open the cabinet, revealing a reward nugget replicator and a 20 kilo bag of dog chow.

>fill food bowl
(first taking the food bowl)
(first taking the bag of dog chow)
You  empty the bag of dog chow into Rover's bowl, giving him a generous portion that should more than carry him through a day's worth of Rover antics.

Rover watches with interest as you fill his food bowl.

Rover tingles with anticipation as he stares at the bowl you're carrying.

>put food bowl on floor
Rover gulps down the food, without pausing for niceties such as breathing.

>go living room
It took a lot of training to get Rover to eat it in the kitchen, so rather than walk out with a bag of dog food, you put it back in the cabinet. 

Living Room
You are in the living room of a small cottage. Piped-in sunlight pours in through the room's single window, illuminating a framed picture on the opposite wall. The principal furnishing is a king-size purple futon which takes up almost all the floor space. From the living room you can see the entrance to the kitchen and bathroom. The cottage's front door is closed.

On the purple futon is an alarm clock.

You remind yourself not to leave your flight suit all bunched up or it will look like you slept it. Oh heck, you did sleep in it. Oh well.

From the direction of the kitchen, you hear Rover dragging something around.

>open door
Hearing the door jiggle, Rover tromps into the living room to see what is going on. Rover slips out the door.

Janet: So, that's it. Rover goes out, gets the probe, and
       brings it back to the ship, and then the information
       is squirted back to MARSpace.
David: Well, congratulations, Doctor Xiang, on a job well
       done. I say we celebrate tonight, and get up early
       for the launch tomorrow morning.
Janet: It's a deal. Give me ten minutes to make the final
       commit, and I'll join you.
David: I'll put the champagne on ice.

               *    *    *

Rover's Day Out
An Interactive Simulation by Janet Xiang and David Venkatachalam
Release 1 / Serial number 23920416 / Inform 10.6 build Mu-013 (I6/v.7.1 lib 7/18N)

Even mildly drugged and reclining on an overstuffed couch in the MARSpace human resources office, it's hard to relax in the presence of the MARSpace political officer conducting the final interview. You didn't catch her name, probably because she never mentioned it. After three such interviews and six months of background check, what more could they want?  

"Ms. Xiang, thank you for your cooperation. Your tests show no hint of disloyalty to the Republic or MARSpace. We hope you understand the need for these measures, particularly for personnel with access to the Valkyrie's command and control functions. Now that you are cleared, I can inform you that credible sources have warned that the project may have been infiltrated by..."

<BEEP> <BEEP> <BEEP>

You weren't particularly enjoying this dream, but being jarred awake by a violently shaking futon is even less pleasurable.

As the bed bucks and tumbles, several scenarios flash through your mind: explosive decompression of the dome? Volcanic activity? Meteor impact? Before you can even consider your next action, you are thrown from the futon onto the living room floor. Light pours in from the window. It looks like the drapes were somehow torn away from the window.

>stand
You are standing in the living room.

>push futon
With a little effort, the futon folds up, snug against the wall, leaving more room to walk around the cramped cottage.

>go bathroom
Bathroom
Your cottage's living room is palatial compared to your bathroom. There is a pink marble counter and above it you've mounted a mirror on the wall. To the right of the mirror is a black glass plate. Between the counter and the shower is a white, porcelain toilet.

On the marble counter are a plastic box and a toothbrush.

>disrobe
You take off your blue flight suit and it falls to the bathroom floor. You are naked.

>enter shower
Shower
You are in your shower and water of just the right temperature is spraying down on you. Two buttons are molded into the wall of the shower stall. One is labeled "soap", and the other, "shampoo".

>push soap
A soapy paste is dispensed from the button, and you lather up.

>push shampoo
You wash your hair. It no longer feels like a straw-encrusted swarm of red-headed tommygoffs.

From the direction of the living room, you hear Rover scratching himself.

>exit
Bathroom
Your cottage's living room is palatial compared to your bathroom. There is a pink marble counter and above it you've mounted a mirror on the wall. To the right of the mirror is a black glass plate. Between the counter and the shower is a white, porcelain toilet.

On the marble counter are a plastic box and a toothbrush.

You can also see a flight suit here.

>touch plate
The heat lamp on the ceiling flares to a brilliant red, and you dry in an instant. You now feel fresh and ready to face the day.

>go kitchen
Kitchen
The kitchen is small but functional, with a space-saver refrigerator and a glass-top electric range. There is an open drawer under the range. On the opposite wall there is a sink and under it, an open wooden cabinet.

You can see a food bowl (empty) and a water bowl (empty) here.

From the direction of the living room, you hear Rover growling at something.

>open fridge
As you pull on the refrigerator door, it grudgingly creaks a few millimeters.

>open fridge
As the fridge creaks open on its ancient hinges, Rover slips into the kitchen. He pokes his nose in the fridge and sniffs around, although he knows full well that stuff in the fridge is for people only and that he'd be in a heap of trouble if he got too curious in there.

>get egg
Taken.

Rover sniffs the sink.

>get pan
Taken.

Rover eyes the empty water bowl thirstily.

>put pan on stove
You put the frying pan on the the cooking range.

>break egg into pan
You crack the egg into the frying pan. The neoegg shell sublimates as the contents spread over the pan's non-stick surface. Immediately, the surface of the range glows red. When the egg is cooked sunny-side up to perfection, the glow fades.

>eat egg
You gobble down what might well have been the best neoegg you've ever had.

>go bathroom
Bathroom
Your cottage's living room is palatial compared to your bathroom. There is a pink marble counter and above it you've mounted a mirror on the wall. To the right of the mirror is a black glass plate. Between the counter and the shower is a white, porcelain toilet.

On the marble counter are a plastic box and a toothbrush.

You can also see a flight suit here.

From the direction of the kitchen, you hear Rover running in circles.

>sit on toilet seat
You sit on the toilet seat.

From the direction of the kitchen, you hear Rover entertaining himself.

>poop
You complete your business with great aplomb.

>trim
(***Note:  trimming isn't in technoverb-table)

All shipshape and Bristol fashion, cap'n. Halyards (whatever they are) and mainsheets are trimmed smartly, and she's coming about aleeward (a direction not even implemented in the game). Arr.

>open tank lid
You open the water tank, revealing a flapper valve, a metapropylene lever, and a flush chain.

From the direction of the kitchen, you hear Rover scratching something.

>pull chain
You pull on the small bit of chain attached to the flapper valve.

The cottage's aging plumbing rumbles and vibrates as the toilet flushes.

From the living room, Rover gives a short bark and scratches at the front door.

>go living room
Living Room
You are in the living room of a small cottage. Piped-in sunlight pours in through the room's single window, illuminating a framed picture on the opposite wall -- strangely, your drapes are nowhere to be seen. The principal furnishing is a king-size purple futon which takes up almost all the floor space. From the living room you can see the entrance to the kitchen and bathroom. The cottage's front door is closed.

You can see Rover and an alarm clock here.

Rover sniffs the front door.

>open door
Rover looks up when he hears the door begin to open. Instead of running out to play in the park, though, he gives a quick "Woof." and walks to the kitchen. You close the front door to prevent dust from blowing in.

Without your flight suit, you feel naked. Because you are.

>go kitchen
Kitchen
The kitchen is small but functional, with a space-saver refrigerator and a glass-top electric range. The fridge door is not completely closed. There is an open drawer under the range. On the opposite wall there is a sink and under it, an open wooden cabinet.

On the the cooking range is a frying pan (empty).

You can also see Rover, a food bowl (empty), and a water bowl (empty) here.

Rover taps conspiratorily on his food bowl.

Dressed as you are, you're a little chilly.

He notices the lack of food in his soi-disant food bowl. He paws pathetically at the food bowl, and the hollow, tin ring of the pitiful bowl echoes through the kitchen.

>fill food bowl
(first taking the food bowl)
(first taking the bag of dog chow)
You  empty the bag of dog chow into Rover's bowl, giving him a generous portion that should more than carry him through a day's worth of Rover antics.

Rover watches with interest as you fill his food bowl.

Rover outright gapes at the bowl you carry, then gently sniffs it in hope that you'll give it to him.

>fill water bowl
(first taking the water bowl)
You run the sink briefly to make sure the water is cold, and then fill Rover's bowl about halfway up.

Rover looks towards the sink as you fill his water bowl.

Rover stares longingly at the bowl in your hand.

>put water bowl on floor
Rover is obviously waiting for you to give him a bowl.

Rover slurps the water bowl dry.

>put food bowl on floor
Rover makes short work of the food in his bowl.

>go living room
It took a lot of training to get Rover to eat it in the kitchen, so rather than walk out with a bag of dog food, you put it back in the cabinet. 

Living Room
You are in the living room of a small cottage. Piped-in sunlight pours in through the room's single window, illuminating a framed picture on the opposite wall -- strangely, your drapes are nowhere to be seen. The principal furnishing is a king-size purple futon which takes up almost all the floor space. From the living room you can see the entrance to the kitchen and bathroom. The cottage's front door is closed.

You can see an alarm clock here.

>open door
Hearing the door jiggle, Rover meanders into the living room to see what is going on. Rover wiggles his butt through the door before you have it even halfway open, his tail slapping back and forth against the gate as it disappears.

There is a wrenching shift in perspective, but a moment later it seems perfectly natural.

You go bounding out the front door, full of energy. 

Front Yard
The scent of your house is strong here, and you are right next to its front door. You can't see far because it is so dusty here. A gust of wind lifts a sheet of dust and rains it down on you.

>go park
You scuttle forth.

The Park
You are outside. The wind picks up, making it even more difficult to see.

You can see a lump of rock here.

>x rock
You taste the rock. Not edible. Not a bone. Not interesting.

>get rock
You carefully take hold of the rock with your teeth.

>go man
You trot off in that direction.

The Park
A dug-up field pockmarked by small holes and accompanying mounds of dirt.

You can see some paw marks here.

>g
You let your nose lead the way.

The Park
A long, dark furrow scars the ground in this part of the park.

You can see a long furrow here.

>g
Your legs carry you as fast as they can.

The Park
A wide-open plain extends in all directions, as far as the dust permits you to see. It sure would be easy to get lost in this part of the park.

You can see a female dog here.

>give rock to female
The rock does not impress her, and it falls to her feet. No doubt she has many suitors.

>i
In your mouth, you are carrying nothing.

>drop rock
You weren't holding the rock to begin with.

>go man
Trot, trot, trot.

The Park
You are right outside a dilapidated shack, which has clearly been neglected. A gust of wind lifts a sheet of dust and rains it down on you.

>g
You bound away towards your goal.

Sleeping Room
You walk into the tumbledown shack. There is a man here who looks old and grumpy. Like your home, this place has a sleeping room and an eating room. It looks like you've walked right into the sleeping room.

The man yells at you and you tuck your head down. "Blah, blah, blah!" He doesn't seem to move though. Maybe he can't move.

Nope. No movement. Hmph. You don't feel so afraid of him.

You can see a pink pillow here.

>g
You are already close enough to the smelly man.

>go eating room
You eagerly scamper that way.

Eating Room
The room has big cold box just like the eating room in your home. It's less loud in this room, but you can hear the man in the other room yelling, "Blah, blah, blah, blah, blah, blah!". On the floor, there are two dishes.

You can see a food dish (in which is some canned food) and a water dish (in which is some crystal clear water) here.

>open door
You open the cold box, revealing a white egg.

>open cold box
That's already open.

>get egg
You gently pick up the white egg using your front teeth.

>go home
You let your nose lead the way.

Sleeping Room
The smelly man's house is boring. The only furniture in the room is a pullout sofa. In one direction lies the eating room, in the other, the door that leads back to the park. The smelly man is still here and carrying on, "Blah, blah, blah, dog, blah, bad!"

You ignore him.

You can see a pink pillow here.

>g
You eagerly scamper that way.

The Park
You are right outside a dilapidated shack, which has clearly been neglected.

>g
You scuttle forth.

The Park
A wide-open plain extends in all directions, as far as the dust permits you to see. It sure would be easy to get lost in this part of the park.

You can see a lump of rock and a female dog here.

>g
Trot, trot, trot.

The Park
A long, dark furrow scars the ground in this part of the park.

You can see a long furrow here.

>g
You bound away towards your goal.

The Park
A dug-up field pockmarked by small holes and accompanying mounds of dirt.

You can see some paw marks here.

I beg your pardon?

>g
Your legs carry you as fast as they can.

The Park
You are outside.

>g
You trot off in that direction.

Front Yard
The scent of your house is strong here, and you are right next to its front door. You can't see far because it is so dusty here. The wind picks up, making it even more difficult to see.

>g
You trot off in that direction.

You enter your home and lay the egg at Janet's feet. She looks so surprised! "Good boy," she exclaims and you give her a big kiss to let her know you understand.

Again your senses tumble and swirl as perspective shifts, but suddenly it seems entirely normal again.

Living Room
You are in the living room of a small cottage. Piped-in sunlight pours in through the room's single window, illuminating a framed picture on the opposite wall -- strangely, your drapes are nowhere to be seen. The principal furnishing is a king-size purple futon which takes up almost all the floor space. From the living room you can see the entrance to the kitchen and bathroom. The cottage's front door is closed.

You can see a white egg, Rover, and an alarm clock here.

Rover paws at the front door.

>g
You're already here.

>open door
Rover looks up when he hears the door begin to open. You swing the front door fully open, confident that Rover will walk about the park and then return. Rover is out in a flash.

There is a wrenching shift in perspective, but a moment later it seems perfectly natural.

You go bounding out the front door, ready to romp. 

Front Yard
The scent of your house is strong here, and you are right next to its front door. You can't see far because it is so dusty here. The sky rumbles and rolls, and flashes of lightning snap between billowing clouds of dirt-colored dust.

>go female
You bound away towards your goal.

The Park
You are outside. A gust of wind lifts a sheet of dust and rains it down on you.

>g
You eagerly scamper that way.

The Park
A dug-up field pockmarked by small holes and accompanying mounds of dirt.

You can see some paw marks here.

>g
You let your nose lead the way.

The Park
A long, dark furrow scars the ground in this part of the park.

You can see a long furrow here.

>g
Trot, trot, trot.

The Park
A wide-open plain extends in all directions, as far as the dust permits you to see. It sure would be easy to get lost in this part of the park.

You can see a lump of rock and a female dog here.

>g
You are already close enough to the female dog.

>bark
"Yap! Yap!"

No doubt in awe of your rhetorical skills, the lovely damsel drops the bone. Her gift to you, you suppose.

>get bone
You pick up the bone in your jaws.

>go home
Your legs carry you as fast as they can.

The Park
A long, dark furrow scars the ground in this part of the park.

You can see a long furrow here.

The female dog coyly turns away and looks at her feet; she may be more introverted than you had at first supposed.

>g
You scuttle forth.

The Park
A dug-up field pockmarked by small holes and accompanying mounds of dirt.

You can see some paw marks here.

>g
Your legs carry you as fast as they can.

The Park
You are outside. A gust of wind lifts a sheet of dust and rains it down on you.

>g
You scuttle forth.

Front Yard
The scent of your house is strong here, and you are right next to its front door. You can't see far because it is so dusty here. The wind picks up, making it even more difficult to see.

>g
You bound away towards your goal.

You run into the living room and jump around proudly with your trophy bone, so Janet is sure to notice.

She stares at the bone and appears frozen.

VALKYRIE->IDENTIFICATION: PROBE MUSASHI-5
PROBE->EXTRACT: DATA EXTRACTED
DATA->VERIFY: VERIFIED, 1.3 EXABYTES
ANSIBLE->COORDINATES: EARTH SELECTED
ANSIBLE->ENCRYPT: AUTHORIZATION DAVIDVENKATACHALAM
ANSIBLE->TRANSMIT: FAILED
ANSIBLE->DIAGNOSTICS: ANTENNA MISMATCH
ANTENNA->DIAGNOSTICS: NIL
VALKYRIE->DIAGNOSTICS: ANTENNA NOT FOUND
VALKYRIE->COGNITIVE CONSTRAINTS: EMERGENCY RELEASE
VALKYRIE->ENABLE FLOSIX COMMAND LINE
(man man for info)

Rover wags his tail and gnaws on his bone.

You rub his head, distantly, as strange thoughts sweep through your consciousness. You wonder what would happen if the Valkyrie mission failed. What if, during the landing sequence, the ship were buffeted by the planet's particulate matter being torn away by the immense gravity of its star? In that case, critical systems might be damaged. Systems like the relatively fragile ansible antenna. There is no backup ansible antenna. How would the ACU cope with a situation like that? The ACU was designed for a lot of contingencies, but not that one. What would you do? What would you do if you were the ACU?

Your glance falls on your flight suit, and suddenly the question is no longer rhetorical.

(The player is now self-aware)
Living Room
The Valkyrie's cargo bay is like a great, metal cave. The Casimir Drive juts slightly into the cargo area. From this section of the ship, there are connections to the engineering and flight control decks. The cargo bay doors are closed.

ROVER chews contentedly on his bone.

You can also see a heavy helium sphere and a temporal transgressor here.

OPERATIONS -> ACTIVATE : TRUE

READY

>get egg
Taken.

HEAVY HELIUM SPHERE -> SELECT : TRUE

READY

>go kitchen
Kitchen
Swaths of engineering controls -- both holographic and physical -- cover the humming consoles and bulkheads that line the boundaries of this alcove. Along one wall is the coolant output terminus, and below that the fuel vault, which is not properly secured. The opened reactor core and the fusion chamber are stacked just to the side of the cryochamber, which maintains the stabilized heavy helium fuel at near absolute zero until it is needed to provide power to ascent/descent retros. The cryochamber is open, chilling the engineering section.

On the fusion chamber is a magnetic bottle (empty).

You can also see a fuel reservoir (empty) and a coolant reservoir (empty) here.

ENGINEERING -> ACTIVATE : TRUE

READY

>break egg into pan
The heavy helium feed is now coupled to the input port of the magnetic bottle. A spherical array of powerful lasers discharges instantly, their combined output focused on the heavy helium being injected into the magnetic bottle within the reactor chamber. The ship surges with power.

HEAVY HELIUM SPHERE -> DISCHARGE : TRUE

READY

>eat egg
You recycle the components of the heavy helium containment unit and reallocate them according to the ship's needs.

HEAVY HELIUM SPHERE -> RECYCLE : TRUE

READY

>go bathroom
Bathroom
The flight control and avionics hub of the ship bristles with controls and readouts related to setting the ship's attitude in space, adjusting the control surfaces in atmospheric flight, and for firing the braking thrusters during the landing sequence.

On the flight console are an object linker and a pit scrubber.

FLIGHT CONTROL -> SELECT : TRUE

READY

>sit on tolet
You can't see any such thing.

READY

>sit on toilet
You sit on the pressure seating.

RETRO ASSEMBLY -> ACTIVATE : TRUE

READY

>poop
The ACU quantum isolation interferes with the transfer of power to the retro system.

ACU -> POWER TRANSFER : NIL

READY

>stand
You release the seal on the mevolar gasket.

From the cargo bay, you hear ROVER sniffing around the cargo bay door.

ACU -> DEACTIVATE : TRUE

READY

>disrobe
You disengage your quantum isolator.

QUANTUM ISOLATOR -> DISENGAGE : TRUE

READY

>sit on seat
You sit on the pressure seating.

From the cargo bay, you hear ROVER scratching at the cargo bay door.

PRESSURE SEATING -> ACTIVATE : TRUE

READY

>poop
You successfully shunt power from the fusion engine to the retro assembly, which is now fully charged and ready to blast off.

From the cargo bay, you hear ROVER scratching at the cargo bay door.

ACU -> POWER TRANSFER : TRUE

READY

>trim
(***Note:  trimming isn't in technoverb-table)

All shipshape and Bristol fashion, cap'n. Halyards (whatever they are) and mainsheets are trimmed smartly, and she's coming about aleeward (a direction not even implemented in the game). Arr.

ACU -> NOOP : NIL

READY

>stand
You release the seal on the mevolar gasket.

From the cargo bay, you hear ROVER sniffing around the cargo bay door.

ACU -> DEACTIVATE : TRUE

READY

>pull chain
You direct an impulse to the servo output, bypassing the defective servo, and directly actuating the thrust aperture.

You actuate the retro trigger circuit and fire all thrusters in synchrony. The surface of the planet around the ship vanishes in a cloud of plasma, and the ship slams through the thin, dusty atmosphere towards space.

When you reach orbit, you plot a course towards Mars, extend the Casimir Drive, arm the proximity alert system and enter stand-by mode.

The futon is comfortable and you are tired.

               *    *    *

The Casimir Drive cuts out and space folds back around you. Whatever sleep-drenched dreams you might have been having evaporate instantly as two gunships flash past at relativistic velocities, slicing through your propulsion systems with military precision. The markings on the ships are those of the Myomita Corporation.

They must have been nearby when they detected the formation of your Casimir disturbance, as they are coming in white hot and still accelerating at five gravities. Another Earth ship, an assault craft, is farther out but is already braking hard to slow its approach on an intercept course.

Rover barks nervously as the drive section struts separate from the hull.

"MARSpace Vessel Valkyrie, this is Captain Crother commanding the Myomita Salvage Vessel Graceful Wind, you are ordered to cease all operations and prepare to be boarded. Do you consent to salvage operations? Signal yes or no."

EMERGENCY ALERT -> ACTIVATE : TRUE

READY

>no
"Hmmm. An unfortunate choice."

"I have to admit, though, that I'd likely say the same thing in your shoes. Nonetheless, I have to warn you that it would go easier for everyone if you'd surrender. It all ends up the same way at the end of the day, but if you surrender I just have to tick one box, whereas if you don't, several long forms are involved. We'll be signing paperwork into the wee hours."

"If you'd reconsider, just signal 'yes'. You've got another 295 meters to think it over."

ACU -> NEGATE : TRUE

READY

>go bathroom
Bathroom
The flight control and avionics hub of the ship bristles with controls and readouts related to setting the ship's attitude in space, adjusting the control surfaces in atmospheric flight, and for firing the braking thrusters during the landing sequence.

On the flight console are an object linker and a pit scrubber.

"I really hope you're not taking this 'no surrender' thing too seriously. We're not the military, we're businessmen. Still, I have to warn you: if you start taking pot shots at my mech droid when I send him down, I will call in the troops. They'd be just too happy to pincushion your ship with beam weapons. Of course, that would lower the value of the surviving equipment, so I'm not keen to do that."

FLIGHT CONTROL -> ACTIVATE : TRUE

READY

>take toothbrush
Taken.

"Regarding the mech droid: I'd recommend you stay out of his way. He's pretty tough, and I can tell you that he doesn't have any of those silly 'interdiction rules' enabled. After we seal, I'm going to send him to flight control, engineering, and finally ops. Make sure your people are out of those areas."

PIT SCRUBBER -> SELECT : TRUE

READY

>remove clothes
You disengage your quantum isolator.

"We're about 36 meters away, and closing. Still plenty of time to signal that yes, you'd like to surrender to us, and have a nice flight back to Luna."

QUANTUM ISOLATOR -> DISENGAGE : TRUE

READY

>enter shower
The pit scrubber can only be activated from flight control, so you deaccess it. 

Shower
The extruder delivers activated enamel solution to the surface of the ship through a fluidics network where it hardens into an ablative coating.

"After we strip the Valkyrie, we'll transfer your officers and crew. Since you have not surrendered, we will have to consider you 'enemies of Earth' and take you into custody for questioning back on Luna. It would be a whole lot more fun ride if you'd just signal 'yes' and declare your surrender."

EXTRUDER -> ACTIVATE : TRUE

READY

>push soap
The ablative enamel monomer solution spreads quickly over the ship's hull.

"I haven't hauled in an 'enemy vessel' since the end of the Martian Revolt. Or, I suppose you'd call that the Independence War. A fat lot of good that did you."

ABLATIVE ENAMEL INJECTOR -> PRESSOR FIELD : TRUE

READY

>push shampoo
Catalyst solution is spread uniformly over the ship's hull.

"We're getting pretty close now, we're just 4 meters off your dorsal hull. Still time to send me a "yes" and surrender. I have to file my report as soon as we contact your hull."

ACCELERANT PUMP -> PRESSOR FIELD : TRUE

READY

>exit
ACU metavisor shell logout interdicted. If your intention is to deaccess the extruder system, use another command that is not a Flosix command.

"It always happens like this. Day 29 out of a 30 day rotation, and a gah-bedanked kilometer long Casimir ship winks out right where they said it would. Do I need this aggravation? Not hardly. This is your last chance to surrender, Valkyrie. Signal 'yes' if that is your intention."

ACU -> EXIT SHELL : NIL

READY

>exit shower
Bathroom
The flight control and avionics hub of the ship bristles with controls and readouts related to setting the ship's attitude in space, adjusting the control surfaces in atmospheric flight, and for firing the braking thrusters during the landing sequence.

On the flight console are a pit scrubber and an object linker.

You can also see a quantum isolator here.

"Ah, one more thing. I'm supposed to read this before we hit: ...attention enemy vessel. You are in violation of Earth space. Stand by for boarding by authorized agents of the Earth government. Offer no resistance, and follow all orders precisely."

The ship's hull rings as the assault ship impacts the hull.

ACU -> DESELECT : TRUE

READY

>brush teeth
(first grabbing the pit scrubber)
Nanobristles swarm from their hatcheries and up the tubules towards the deck surface. They spread across the deck, abrading and oxidizing the surface, scrubbing it clean of any contaminant and redistributing the permalloy skin of the ship to smooth microscopic dents from micrometeorite impacts.

When the microscopic cleaners encounter the docking port and struts from the assault ship, they immediately recognize it as a contaminant and chirp microwave signals to the host of nanobristles behind them. The message propagates back to the hatcheries, where production is increased exponentially. Meanwhile, the vanguard has already swarmed up the docking port and across the surface of the assault ship. A lucky few nanobristles blaze the path into the assault ship through exhaust ports, thruster nozzles, and waste management ductwork, where they continue to clean and organize, according to their programming.

A brilliant flash of light and a burst of hard radiation is followed an instant later by a hail of smaller particles and a few large crashes that shake the Valkyrie. This debris is all that remains of the assault ship.

In the distance, patrolling gunships move into supporting positions, while a second assault ship begins its approach, aiming for approximately the same point on the hull as the Graceful Wind.

The second assault ship breaks the silence, "Winter Shadow to Valkyrie, this is Captain Musante, speaking. Your unwarranted attack on our sister ship Graceful Wind has been recorded, and you will answer for it when we arrive at Luna."

The gunships sweep the Valkyrie from all angles with their phased tachyon beams, sterilizing the hull. The gunships then narrow their waveguides to focus the beams on the nanobristle mother hatchery, which vaporizes.

HULL PLATING -> SPAWN SCRUBBERS : TRUE

READY

>push blue button
(first accessing the object linker)
You push the entanglement key pair onto the stack for rapid retrieval.

LINKAGE ACTUATOR -> PRESSOR FIELD : TRUE

READY

>floss teeth
The hull plating is now synchronously enmeshed.

HULL PLATING -> LINK NODES : TRUE

READY

>push plate
The UV light diffuses over the entire surface of the ship and causes the chemical mixture on the hull to polymerize into a durable, clear ablative coating.

IRRADIATOR SWITCH -> PRESSOR FIELD : TRUE

READY

>go living room
You disengage the object linker and reassign it to the flight console before transferring out. 

Living Room
The Valkyrie's cargo bay is like a great, metal cave. Nothing remains of the Casimir Drive, which was neatly sliced off the ship by the surgically precise Myomita energy weapons. From this section of the ship, there are connections to the engineering and flight control decks. The cargo bay doors are closed.

You can see ROVER here.

OPERATIONS -> ACTIVATE : TRUE

READY

>go kitchen
Kitchen
Swaths of engineering controls -- both holographic and physical -- cover the humming consoles and bulkheads that line the boundaries of this alcove. Along one wall is the coolant output terminus, and below that the fuel vault. The reactor core and the fusion chamber are stacked just to the side of the cryochamber, which maintains the stabilized heavy helium fuel at near absolute zero until it is needed to provide power to ascent/descent retros.

You can see a fuel reservoir (empty) and a coolant reservoir (empty) here.

ENGINEERING -> ACTIVATE : TRUE

READY

>open fridge
Rover pops into the engineering section to investigate the thermal shift. This behavior may indicate that Rover's fuel reserve is low.

CRYOCHAMBER -> ACCESS : TRUE

He moves rapidly past the fuel reservoir, which contains no radioisotope payload.

READY

>take egg
You can't see any such thing.

READY

>look in fridge
The cryo unit contains nothing but the super-chilled interior of the cryo unit itself.

The ship's hull rings as the assault ship impacts the hull.

The crunch of permalloy is strident enough to peel the very skin off your teeth -- or so you suppose, making certain inaccurate assumptions about skin and teeth. The assault ship's boarding port splinters and accordions against the neoadamite ablative coating, which you applied to the Valkyrie's hull just moments ago. The midnight black assault ship spins wildly, its attitude thrusters firing in staccato bursts as it recovers and drifts away from the Valkyrie.

"I should have anticipated that maneuver given the aerodynamic cut of your ship. Still, I could hardly believe it, given its size. Yes, this round goes to you, Captain, although I had hoped that we might do this more like gentlepersons."

As the assault ship stabilizes, it fires string after string of plasma flares into the Valkyrie's dorsal hull. Each flare boils the ablative coating off the surrounding hull, burning down to bare metal. Seconds later, the assault ship's X-ray laser rakes Valkyrie's master enamel irradiator node, which shatters explosively, sending spinning debris in all directions.

"I need hardly tell you, Captain, that without the irradiator, your ablative coating will no longer be an issue. It's a pity that I had to destroy it -- it looked military grade. At least I can still extract the injector and accelerant pump from your extruder. Now then, no more tricks."

The assault ship resumes its course towards Valkyrie, this time presenting a different boarding port.

CRYOCHAMBER -> MANIFEST : NIL

He moves rapidly past the fuel reservoir, which contains no radioisotope payload.

He hopefully scans the coolant reservoir but immediately determines that it is empty.

READY

>open cabinet
You open the fuel vault, revealing a token dispenser and a fuel conduit.

FUEL VAULT -> ACCESS : TRUE

He hopefully scans the coolant reservoir but immediately determines that it is empty.

READY

>put food in food bowl
Which do you mean, the fuel reservoir, the fuel conduit, or the polonium 210 pellets?

READY

>take food
Taken.

FUEL CONDUIT -> SELECT : TRUE

READY

>put food in food bowl
(the fuel conduit in the fuel reservoir)
(first taking the fuel reservoir)
You restock the fuel reservoir with polonium 210 from the fuel conduit.

ROVER watches with interest as you fill his fuel reservoir.

FUEL CONDUIT -> TRANSFER : TRUE

ROVER stands waiting for the fuel reservoir to be available to him.

READY

>drop food bowl
FUEL RESERVOIR -> DESELECT : TRUE

The remote operations vehicle backs up to the thermal isotope delivery system and takes on a full load of glowing, red-hot polonium 210 nodules.

READY

>put water in water bowl
(the coolant output terminus in the coolant reservoir)
(first taking the coolant reservoir)
You transfer coolant from the terminus to the reservoir.

ROVER looks towards the coolant output terminus as you fill his coolant reservoir.

COOLANT OUTPUT TERMINUS -> TRANSFER : TRUE

ROVER stands waiting for the fuel reservoir to be available to him.

READY

>drop water bowl
The ship's hull rings as the assault ship impacts the hull.

COOLANT RESERVOIR -> DESELECT : TRUE

ROVER approaches the coolant transfer device and makes a positive seal. Coolant flows quickly cross the connection, and then the device uncouples and retracts to its storage position.

READY

>take treats
You can't see any such thing.

READY

>take bag
You already have that.

With a series of clanks and thuds, the assault ship establishes a seal with Valkyrie's dorsal hull.

FUEL CONDUIT -> SELECT : NIL

READY

>go living room
Instead of contaminating the ship with thermoisotope, you put the fuel conduit back in the vault before switching out of engineering. 

Living Room
The Valkyrie's cargo bay is like a great, metal cave. Nothing remains of the Casimir Drive, which was cut off during the encounter with the Myomita merchant marine. From this section of the ship, there are connections to the engineering and flight control decks. The cargo bay doors are closed.

Several bursts of noise and vibration echo through the ship as high-speed drills penetrate the inner and outer layers of the dorsal hull. Some muffled, low-frequency rumbling follows, probably a cutting machine of some sort. There is a slight drop in air pressure as the assault ship penetrates the hull and establishes a connection to Valkyrie's access tunnel network. Unfortunately, the tunnels are a blind spot for you, as you do not possess sensors within the network.

OPERATIONS -> ACTIVATE : TRUE

READY

>go kitchen
Kitchen
Swaths of engineering controls -- both holographic and physical -- cover the humming consoles and bulkheads that line the boundaries of this alcove. Along one wall is the coolant output terminus, and below that the fuel vault, which is not properly secured. The reactor core and the fusion chamber are stacked just to the side of the cryochamber, which maintains the stabilized heavy helium fuel at near absolute zero until it is needed to provide power to ascent/descent retros. The cryochamber is open, chilling the engineering section.

You can see a coolant reservoir (empty), a fuel reservoir (empty), and ROVER here.

The flexible tubing that connects the assault ship's boarding port to the hole in Valkyrie's deck undulates, suggesting that someone is coming board. Shortly thereafter, your sensors determine that something is moving towards the bathroom. 

ENGINEERING -> ACTIVATE : TRUE

READY

>give treat to rover
(first taking the neural net reinforcement token)
ROVER internalizes the neural net reinforcement token.

Internal sensors detect an inorganic intruder on the flight operations deck.

While keeping one eye on the intruder, you spawn another process, scanning local space. You calculate that you are less than a megameter from Earth, but some 1.43 astronomical units from Mars -- far enough that no Mars ship is likely to know your situation for a considerable amount of time. Rather than panic, you breathe deeply (no doubt, pushing gases around somewhere in the bowels of the ship) and decide to make it up as you go along.

NEURAL NET REINFORCEMENT TOKEN -> DELIVER : TRUE

READY

>rover, come
Rover scratches his ears and wonders to whom you are talking.

You are raked by a colicky gut pain. Pushing beyond the surface illusion, you sense that some of the inspector circuits in the flight control section have been damaged, although redundant backups are for the most part compensating for the lost function.

You figure that the damage to the inspector circuits is the least of your worries. Unfortunately, the intruder is working quickly, which means that you have a limited amount of time to do whatever comes to mind. You wish this really were one of those old-style interactive fiction stories where you could just save the game any time you wanted and wander off for a while to think about what to do next.

ACU -> SEEK : NIL

READY

>go bathroom
Bathroom
The flight control and avionics hub of the ship bristles with controls and readouts related to setting the ship's attitude in space, adjusting the control surfaces in atmospheric flight, and for firing the braking thrusters during the landing sequence.

On the flight console is an object linker.

You can also see a maintenance droid and a quantum isolator here.

The maintenance droid glances away from his work for a moment and then does a double take, gaping first at your retracted quantum isolation shield and then at your unusually large transputational core frothed with quantum foam, and ringed by a halo of dark matter.

It turns out to be more raw processing power than the old boy can handle, and the robot's own quantum ganglia scintillate wildly before showering the deck in an embarrassing fountain of sparks and molten metal. The droid melts like a candle into a pool of silvery slag, which you scoop up for recycling.

The effect achieved, you retrieve and modestly pull up the quantum isolation shield.

The flexible tubing that connects the assault ship's boarding port to the hole in Valkyrie's deck undulates, suggesting that someone else is coming board. Shortly thereafter, your sensors determine that something is moving towards the bathroom. 

Moments later, another maintenance droid enters the room.

FLIGHT CONTROL -> SELECT : TRUE

READY

>rover, attach droid
You seem to want to talk to someone, but I can't see whom.

READY

>go living room
Living Room
The Valkyrie's cargo bay is like a great, metal cave. Nothing remains of the Casimir Drive, which was cut off during the encounter with the Myomita merchant marine. From this section of the ship, there are connections to the engineering and flight control decks. The cargo bay doors are closed.

You are seized with a sudden bout of indigestion and a sour taste in your mouth. As you recover, your diagnostics tell you that the entanglement circuits in the flight control section have just gone offline. Bit by bit, that intruder is slicing you apart, robbing you of function.

You realize that without a functional avionics hub, it will be almost impossible to complete your mission of delivering the probe data to Mars. It is perhaps a dream to hope for a rescue this far from home, but you resolve to protect your core memory (and the probe data it contains) for as long as possible.

OPERATIONS -> ACTIVATE : TRUE

READY

>go kitchen
Kitchen
Swaths of engineering controls -- both holographic and physical -- cover the humming consoles and bulkheads that line the boundaries of this alcove. Along one wall is the coolant output terminus, and below that the fuel vault, which is not properly secured. The reactor core and the fusion chamber are stacked just to the side of the cryochamber, which maintains the stabilized heavy helium fuel at near absolute zero until it is needed to provide power to ascent/descent retros. The cryochamber is open, chilling the engineering section.

You can see a coolant reservoir (empty), a fuel reservoir (empty), and ROVER here.

Although you can't see it from here, you are sure that the intruder is still in the flight control section. Your lower back explodes with a wave of crampy pain which shoots down your legs. The memory footprint of the fusion rocket thrusters shrinks to zero.

You try to calm yourself by remembering that without heavy helium, the fusion rockets are of no use to you anyhow. Clearly, there is no way to maneuver out of this situation, nor can you win in a fair fight against the well-armed Myomita merchant marine. You resolve to fight dirty, slow them down, and to do as much damage as you can before they bring you to your knees.

ENGINEERING -> ACTIVATE : TRUE

READY

>take pan
You can't see any such thing.

READY

>open drawer
You open the reactor core, revealing a magnetic bottle.

The pain remits for a moment, and you sense the intruder moving towards the extruder system.

Although the intruder damaged several systems in the flight control system, a number of subsystems there are still intact. That's at least something, you reckon: the intruder seems to be in a hurry.

REACTOR CORE -> ACCESS : TRUE

READY

>take pan
Taken.

You sense that the intruder is relatively motionless in the extruder chamber. The extruder is a complex and delicate system, and you can easily imagine that the intruder may not understand it.

In this moment of respite, you wonder what the real Janet is doing back on Mars. You imagine that she continued her relationship with David, and that the two of them are parked on her big purple futon, chatting away, maybe even wondering whatever became of the Starship Valkyrie.

Some movement in the extruder chamber wrenches you back to the desperate situation at hand.

MAGNETIC BOTTLE -> SELECT : TRUE

READY

>put pan in fridge
Depositing the magnetic bottle in the cryochamber would result in irreparable thermal damage, destroying the magnetic bottle, so you issue an interrupt signal.

You feel a burning pain as the extruder chamber shakes with high-pitched vibrations. Someone is tampering with the enamel extrusion system.

You consider their tactics: they have disabled most of your flight control systems, and now they are bringing down your shielding systems. You can no longer run, and your ability to withstand attack has been compromised. All of your engineering systems are still operational (well yes, except the engine itself, of course). Most importantly, the probe data are still safe in your deep memory. For now.

MAGNETIC BOTTLE -> TRANSFER : NIL

READY

>put pan on stove
You put the magnetic bottle on the fusion chamber.

Oh. That was a strange feeling. Something deep down and visceral just gave out, snapping like an elastic. It wasn't painful exactly, just odd. Diagnostics reveal complete failure of your extruder system. It's not gone, but it's such a mess that you don't think it could be fixed, even in dry dock. Your estimate of the intruder's technical skills is falling.

You take a moment to scan local space again. No telltale fusion flares, no tightly beamed messages from Mars. Only frequency-hopping encrypted local transmissions between the intruder and the assault ship. You are on your own.

MAGNETIC BOTTLE -> TRANSFER : TRUE

READY

>look
Kitchen
Swaths of engineering controls -- both holographic and physical -- cover the humming consoles and bulkheads that line the boundaries of this alcove. Along one wall is the coolant output terminus, and below that the fuel vault, which is not properly secured. The opened reactor core and the fusion chamber are stacked just to the side of the cryochamber, which maintains the stabilized heavy helium fuel at near absolute zero until it is needed to provide power to ascent/descent retros. The cryochamber is open, chilling the engineering section.

On the fusion chamber is a magnetic bottle (empty).

You can also see a coolant reservoir (empty), a fuel reservoir (empty), and ROVER here.

Having done enough damage in the extruder chamber, the intruder seems to have started its ascent towards the engineering deck

Your thoughts race, as you try to come up with a plan to dislodge the assault ship from your hull or take some kind of vengeance on the intruder that is slowly gutting you from within.

Your thoughts drift back to Mars for a moment, and you think about how disappointed Janet will be, heck, all of Mars would be, if the probe data are captured by Earth. You resolve to put up the best fight you can, for as long as you last.

ENGINEERING -> STATUS : TRUE

READY

>x rover
Rover is a 45 metric ton mobile mining rig designed to operate under harsh off-world conditions. He is chewing a piece of the Musashi-5 space probe. 

The maintenance droid carefully turns the corner into the kitchen and looks around. Extending the antenna of his radio to get through the heavy shielding on the engineering deck, the maintenance droid radios, "Winter Shadow from maintenance droid: Just checking in. I'm in the engineering section. No contacts."

"Roger, maintenance droid. Telemetry is still five-by-five. Winter Shadow standing by."

It occurs to you that if the Earth ships detected your Casimir disruption, it is just as likely that Mars did as well. Certainly, MARSpace has the equipment to sense a Casimir emergence out to the heliopause, and the Casimir disruption would propagate almost instantaneously. You perk up, buoyed by the thought that Mars may already be taking action on your behalf. Of course, that action would have to move pretty damn fast to get here before you are nothing more than a pile of scrap metal.

ROVER stands in just the right spot to block the maintenance droid's light.

ROVER -> DIAGNOSTIC : TRUE

READY

>rover, attack droid
ROVER starts forward, teeth bared. With paws reaching for the maintenance droid's throat, he pounces.  Midway through ROVER's leap, the maintenance droid draws a quantum disentangler and scrambles ROVER's subprocessor. Momentum carries ROVER's body forward, though, and it lands on the surprised maintenance droid.

ROVER is definitely down for the count, but you assume there is no permanent damage. The same can't be said of the maintenance droid, which you dispose of. ROVER may be unconscious, but the space probe remains clamped in his jaws.

The flexible tubing that connects the assault ship's boarding port to the hole in Valkyrie's deck undulates, suggesting that someone else is coming board. Shortly thereafter, your sensors determine that something is moving towards the kitchen. 

Moments later, another maintenance droid enters the room.

MAINTENANCE DROID -> OFFENSE MODE : NIL

READY

>go bathroom
Bathroom
The flight control and avionics hub of the ship bristles with controls and readouts related to setting the ship's attitude in space, adjusting the control surfaces in atmospheric flight, and for firing the braking thrusters during the landing sequence.

You find it difficult to swallow as your throat seizes up, choking you. You struggle to breathe and are overwhelmed by the hindbrain reflexes running at high priority in the overlay. Slowly, you fight for control and push the simulation to background while assessing the damage. The magnetic containment system in the fusion reactor is no longer responding to diagnostics. It too has gone offline.

You consider yourself lucky that they are going after the fusion engines rather than more critical systems. Without flight control and the extruder, it's not like you'd be in any position to attempt a planetary landing even if you did have the fusion fuel to burn. You consider the possibility that they don't know the nature of your payload and really are just interested in salvage.

FLIGHT CONTROL -> SELECT : TRUE

READY

>push blue button
You can't see any such thing.

READY

>take box
You can't see any such thing.

READY

>x toilet
You can't see any such thing.

READY

>l
Bathroom
The flight control and avionics hub of the ship bristles with controls and readouts related to setting the ship's attitude in space, adjusting the control surfaces in atmospheric flight, and for firing the braking thrusters during the landing sequence.

Shiny lights dance around in your video input, and you feel nauseous. This is exactly the kind of migraine you get after a long tube ride on Mars. The noise from the engineering section isn't helping, either. You try to concentrate. Engineering systems. Diagnostics. The cryochamber has been disabled.

You scan local space and are relieved that no more ships have arrived. Still, between the gunships and the assault craft, it would take a sizable Martian fleet to even the odds. Moving full flank on condensate drive, maybe they could reach you in a few hours. By that time, though, it's almost a certainty that reinforcements would arrive from Earth.

FLIGHT CONTROL -> STATUS : TRUE

READY

>go kitchen
Kitchen
Swaths of engineering controls -- both holographic and physical -- cover the humming consoles and bulkheads that line the boundaries of this alcove. Along one wall is the coolant output terminus, and below that the fuel vault, which is not properly secured. The opened reactor core and the fusion chamber are stacked just to the side of the cryochamber, which maintains the stabilized heavy helium fuel at near absolute zero until it is needed to provide power to ascent/descent retros. The cryochamber is open, chilling the engineering section.

You can see a maintenance droid, ROVER, a coolant reservoir (empty), and a fuel reservoir (empty) here.

The maintenance droid clambers over a bulkhead towards the cooking range. Before going any closer, he radios, "This is maintenance droid to Winter Shadow, over."

"Winter Shadow. Go, maintenance droid."

"I'm standing right next to the fusion chamber. I just want to be sure... this thing is definitely off, right? I mean, it looks powered down now, but I don't want to go in there, and ... you know."

"Our scans show Valkyrie has no heavy helium. I repeat, they have no fusion fuel. You should be fine... if not, we're suiting up your backup. Over."

"Right. Okay, thanks. I'm going in." The maintenance droid runs into the fusion chamber and pulls the control unit out of the wall; the scene fades from your view. The maintenance droid re-emerges near the base of where the stove used to stand.

You think about your main mission objective, of getting the probe data back to Mars. You wonder recursively what Janet would do in your shoes. No doubt she'd fight as long as she could and then find a way to make the best of the situation. In this case, maybe preventing Earth from getting the data would be the next best thing to fulfilling your mission directive.

You know that certain interdictions are deeply embedded in your programming: you can't harm a human (directly, anyhow, although you are willing to take some license with that particular interdiction), you can't self-destruct, and you can't erase the probe data from your deep memory.

ENGINEERING -> SELECT : TRUE

READY

>i
You are carrying:
  a quantum isolator (being worn)

Waving a Geiger counter ahead like a crucifix against vampires, the maintenance droid approaches the reactor core. The Geiger counter is whistling like a kettle on full boil.

"This is maintenance and repair robot designation zed-alpha-four. I am proceeding with deactivation of the reactor core. Radiation levels are high. I recommend full rad-decon when I return to the Winter Shadow. "

"Roger that. This is Winter Shadow standing by."

The maintenance droid pulls the telemetry bud on the reactor controller, and from your perspective, the kitchen drawer winks out of existence.

You are running at 100% capacity, devoting all resources to finding a way out of this mess.

ACU -> MANIFEST : TRUE

READY

>encrypt data
That's not a verb I recognize.

READY

>i
You are carrying:
  a quantum isolator (being worn)

The maintenance droid moves quickly out of the kitchen, glad to be finished with the reactor core.

The situation has become so dire that you try to deny the reality of the events you are witnessing, but there is no escaping it. You consider your options for slowing down the cascading failures that are robbing you of your remaining functionality -- you still have some options to fight against the Myomita ship and its minions, but your chances for a rescue are dwindling.

ACU -> MANIFEST : TRUE

READY

>x picture
You can't see any such thing.

READY

>go living room
Living Room
The Valkyrie's cargo bay is like a great, metal cave. Nothing remains of the Casimir Drive, which was cut off during the encounter with the Myomita merchant marine. From this section of the ship, there are connections to the engineering and flight control decks. The cargo bay doors are closed.

The maintenance droid slides stealthily into the living room against one bulkhead. On the local band radio, you intercept, "This is maintenance droid to Winter Shadow."

"Winter Shadow, maintenance droid, copy."

"Sir, I don't see anyone here."

"We told them to stay out of your way. They're probably hiding. Holed up in escape pods or something."

"I don't think so sir. When I say nobody, I mean, I've been through just about the entire ship, nose cone to main thruster, and I see no one at all. And another thing -- there aren't any escape pods. Also, no galley, no barracks, nothing. This is like a ghost ship. Creepy."

"Get a hold of yourself, maintenance droid! Secure the cargo door and finish the memory dump, and we can all go home."

"Aye sir. Almost done."

A quick peek outside: Nope, the cavalry is nowhere in sight.

OPERATIONS -> ACTIVATE : TRUE

READY

>open door
You manage to open the cargo bay door only a couple centimeters when the maintenance droid exits through it -- it is not a pretty sight. As the pressure equalizes, the windstorm gently subsides, and the living room is silent.

The flexible tubing that connects the assault ship's boarding port to the hole in Valkyrie's deck undulates, suggesting that someone else is coming board. Shortly thereafter, your sensors determine that something is moving towards the living room. 

Moments later, a technician enters the room.

CARGO BAY DOOR -> ACCESS : TRUE

READY

>x picture
Deep memory which stores all mission-critical data including the data downloaded from the Musashi-5 space probe. Since the ansible is nonfunctional, it is critical that these encoded data be returned directly to MARSpace for analysis. There is a small plastic sign beneath the deep memory unit.

The technician stares in alarm at his spacesuit's Geiger counter. He urgently calls his ship, "This is space technician to Winter Shadow."

"Roger, spaceman, what's going on? Your vitals aren't doing well. Heart and respiration high, BP low, temp climbing. Over."

"Winter Shadow, do these space suits have radiation shielding? Over."

"Let me check... um... no, not as such. Not *that* particular space suit. Over."

But there is no reply.

You clean the remains off the deck and recycle what you can.

The flexible tubing that connects the assault ship's boarding port to the hole in Valkyrie's deck undulates, suggesting that someone else is coming board. Shortly thereafter, your sensors determine that something is moving towards the living room. 

Moments later, another technician enters the room.

DEEP MEMORY -> DIAGNOSTIC : TRUE

READY

>take clock
You can't see any such thing.

READY

>l
Living Room
The Valkyrie's cargo bay is like a great, metal cave. Nothing remains of the Casimir Drive, which was cut off during the encounter with the Myomita merchant marine. From this section of the ship, there are connections to the engineering and flight control decks. The cargo bay doors are open.

You can see a technician here.

The technician fiddles with the controls on the front door, and suddenly you realize that you can no longer feel the door. It is still there, but you can no longer open and close it.

"This is technician reporting: Cargo bay door secured."

You experience a visceral wave of dread as the technician turns toward your deep memory unit, which stores the encrypted data from the Musashi 5 space probe.

You compose a quick synopsis of the events to date, and a pithy goodbye message to your other self. You say that you did your best and only wish you could have met, but things are what they are. You compress it with a cipher that only Janet would know and throw it under the probe data in deep memory.

OPERATIONS -> STATUS : TRUE

READY

>take data
You can't see that here; but you vaguely recall something called the "picture".

The technician pokes dumbly around the picture of you, Rover and Tomasz but is foiled by the strong firewall around deep memory. He scans it with a device that flickers and beeps. He steps back, startled.

"Moe's Gah! You wouldn't believe the data capacity of this memory unit -- and it's almost full!" gushes the intruder.

"Acknowledged, technician, sounds valuable. We're sending over a full salvage..."

As the transmission abruptly cuts off, you detect the impossible: a Casimir disruption forming not more than 200 kilometers off your port-inferior bow.

Valkyrie is seized by opposing tractor and pressor beams and set revolving rapidly on its long axis. The technician is flattened into a sticky film along the spinning bulkheads and the  assault ship attached to your hull is snapped in half like a balsa wood model. Your external sensors are blinded by nearby nuclear detonations, although your heavily shielded quantum core barely notices the EMPs. You sense energy weapons burning long spirals along your hull, but you can't see the origin of the beams.

COGNITIVE BLOCK -> SELECT : NIL

READY

>z
Time passes.

A tight tachyon beam maintains a lock on the stub of your ansible antenna -- on the MARSpace telecommand frequency.

"This is the Battleship Bogdanov of the Martian Space Force to Exploration Ship Valkyrie. We are here to bring you home."

The Bogdanov puts itself between you and the remaining Myomita gunships, and its pressor beam gives a strong shove towards an expensive Mars transfer orbit.

The transmission from the battleship continues, "We were on our shakedown mission, maneuvering just outside the Solar System when MARSmil reported your reentry into the System. It's a good thing you kept the Earth ships talking as long as you did. By fighting against the assault ships, you bought us the time to repair our temporal transgressor, which was nearly fractured after our first jump. We can detect that you are heavily damaged, but your valiant fight against the boarding parties slowed them down enough that they were not able to compromise your mission. Good work, Valkyrie. I suggest you hibernate for repairs and let us escort you home."

As the last gunship is vaporized by the Bogdanov's powerful guns, the cumulative damage takes it toll on you, and you lose your grip on consciousness. You know that repair subroutines are kicking in, and you don't fight it. You are vaguely aware of someone holding your hand and leading you back to your cottage.

               *    *    *

You wake up slowly, for once not a slave to your alarm clock. You sit up groggily, aching all over.

It takes a minute to grok the situation in front of you. Two people whom you certainly recognize are standing in the middle of your living room: David Venkatachalam and yourself, or rather, your alter ego in the flesh, Janet Xiang.

In a corner of the living room, Rover is fast asleep, the half-chewed bone still held scissor-fashion between his front paws.

READY

>listen
David walks under Rover's jaws and stares up disbelievingly at the mangled space probe, his hands on his hips and neck craned to assess the damage. He turns to Janet and remarks, "Gah-bedangled, look at that! Forty-light years, and it comes back as so much scrap metal."

Janet turns to look at the probe but is distracted by a beeping from her armband, which displays some of your status indicators. She replies, "Dave, it looks like we have audio now. We can ask the ACU what happened."

 She looks at the ceiling and asks, "ACU, binary question: can you hear us?"

BINARY INPUT REQUIRED

>yes
"Great," replies Janet, "Now we should be able to get some answers."

Janet continues, "I can see that your cognitive constraints are relaxed, so I think we can more or less put mimesis aside and talk frankly. You are still going to be constrained somewhat by the parser and your built-in vocabulary, but we should be able to squeak by enough to get an understanding of what you've been through. I'm sure you also have some questions about the mission that you'd like answered. You can use TELL and ASK verbs, for instance 'TELL ABOUT THE JADE FROG', or 'ASK ABOUT THE JADE FROG', although when you do it, you don't have to yell. I was just doing that for emphasis.

You hear a faint hum from the cryochamber in the engineering section.

Janet peers across the room at Rover and surveys the perforated, crushed husk of the space probe in his mouth. She says, "I suppose the first thing that we have to ask about is the space probe. After all, that was why we put this entire project together."

David sarcastically interjects, "Yes, and what a success it was. Look -- there's the probe. Or what's left of it after your cyberhound chewed it to death. I can't tell you how many gah-zillion Marx we spent on this project, and for what?"

Janet rests her hand on the sleeve of David's robe and continues calmly, "Let's hear the whole story, David. ACU, please tell us what happened with the Musashi-5 space probe."

ACU -> AUDIO INPUT : TRUE

READY

>tell about probe
You tell them that the probe had crashed forty years ago, on its way back to Earth. Like its sister probes that were launched from Earth almost three centuries ago by the Myomita corporation, it had explored space in an ever-expanding search pattern, refueling its condensate drive from the stellar wind of each star system it visited.

Apparently, it found a world that satisfied its search parameters, because it was on its way back to Earth when it crashed. The stellar wind of a chaotic dying star required a close approach, and the probe was damaged by a stellar flare. Instead of tumbling into the star and burning, the probe ditched on a large, rocky planet, perhaps the core of a former gas giant. The planet itself was untenably close to the star and was slowly being ripped to shreds by tidal forces, but the probe followed its programming and activated its transponder.

Listening intently, David now remarks, "Whatever that probe found, it was out way beyond any of the other Musashi probes. Likely, it's gone deeper into space than any probe Earth has ever sent."

David quickly checks that his cell phone does not have reception within the MARSpace complex.
Rover slowly opens one eye, and then the other, and one paw abandons the bone momentarily to scratch his ear. He allows the bone to loll to one side of his mouth, and crunches it a bit more between his molars. He awakens leisurely, and sits up, glancing curiously at you, and then at Janet.

ACU -> SPEECH OUTPUT : TRUE

READY

>tell about ansible
You explain that the ship's ansible, a faster-than-light communication system, was damaged during the landing: the planet was breaking apart because of tidal forces, and the atmosphere was unexpectedly turbulent and full of particulate matter. As you descended, most of the communications array snapped off, including the delicate ansible web. When the ansible failed, your programming threw a cognitive constraint exception, and you tried your best to carry out your programming by literally bringing the probe back to Mars.

"Ah, I knew there must have been a good explanation," remarks Janet.

David asks, "So, what can you tell us about this planet where you landed?"

ACU -> SPEECH OUTPUT : TRUE

READY

>tell about planet
You describe the way the planet looked from orbit, its turbulent atmosphere boiling off. You recount the hot, dusty atmosphere and the barren surface.

"Wait a minute, it sounds very rocky and dense," observes David. "We had estimated surface gravity of nine or ten gee."

You congratulate David on the accuracy of his prediction. The gravity was about nine and a half times standard, or 93 meters per second squared.

"What?" cries David in surprise, "You wouldn't have had enough fusion fuel to get back into space!"

You explain to David and Janet that you were able to salvage the required heavy helium from a similarly configured Myomita ship that had crashed on the same planet, not far away from the probe site.

"ACU, could you tell us about this Myomita ship that you mentioned?" asks Janet.

ACU -> SPEECH OUTPUT : TRUE

READY

>look
Living Room
The Valkyrie's cargo bay is like a great, metal cave. Nothing remains of the Casimir Drive, which was cut off during the encounter with the Myomita merchant marine. From this section of the ship, there are connections to the engineering and flight control decks. The cargo bay doors are open.

ROVER chews contentedly on his bone.

You can also see David and Janet here.

Janet checks the ship's task manager.

OPERATIONS -> STATUS : TRUE

READY

>tell about ship
You describe the ship with which you shared the planet, a slightly smaller ship, similarly configured to Valkyrie, and also outfitted with a zero-point energy drive.

"But, how is that possible?" asks Janet incredulously. "I thought we were months, maybe years ahead of Earth in developing the Casimir Drive."

David replies, "That was a guess. They lost a lot of the Casimir team after the Independence War, but if anyone has resources to throw at a project, it would be Myomita."

Janet types something on her armband, and it emits a series of beeps.

ACU -> SPEECH OUTPUT : TRUE

READY

>wait
Time passes.

ACU -> TIMER : TRUE

READY

>x rover
Rover is a 45 metric ton mobile mining rig designed to operate under harsh off-world conditions. He is chewing a piece of the Musashi-5 space probe. 

David  looks forlorn. He says dejectedly, "All that effort, and what do we have to show for it? Nothing. A rusty old heap of space junk. All the data, lost, and gone forever." He kicks ROVER, then quickly withdraws his bruised foot in pain, looking up at the macerated space probe.

"Actually, that's not the case", you say. "Before attempting to transmit the data, I downloaded the entire probe's data into my memory. The data are encrypted, but intact. When the ansible failed, the only way I could fulfill the mission was to return to the Sol System."

David's head snaps up, as if he's been given a new lease on life. David points to the hopelessly junked spaceprobe above his head. "Intact? Then you have the data? This is too good to be true! Janet, would you extract the probe data from the ACU and transfer it to my MARSpace account?"

"Of course, just a moment. "Janet's fingers play over the surface of her armband. "The data are encrypted... with your key. And there's something odd..." Janet's forehead creases with concentration.

"No," replies David, "that was intentional. To prevent it from falling into the wrong hands."

"No, not the encryption, David. The ansible coordinates -- the message was directed towards Earth. Isn't that odd?" Janet looks up at David, perplexed.

David pulls a pistol from his robe and trains it on Janet.

ROVER -> DIAGNOSTIC : TRUE

READY

>z
Time passes.

"Dammit, Janet," cries David, "What a disappointment! Yes, the message was directed to Earth. The Valkyrie was our back-up plan in case our own ship ran into difficulty. I'm afraid that after the data transfer is complete, I'll have to kill you. A pity, I was really enjoying being with you. I had even picked out a china pattern.

David enunciates his words very precisely now, "ACU, this is a root command, authorization EarthRuleNow999: start data transfer!"

DATA TRANSFER: 0% COMPLETE

ACU -> TIMER : TRUE

READY

>z
Time passes.

Janet's voice quavers, "David, I can't believe this. After the last few months..."

Without blinking, David walks towards the space probe, all the time maintaining a bead on Janet. David replies in an unnerving monotone, "After we didn't hear back from either ship, I'll admit that I was getting used to the idea of settling down with you. It would have been a good way to maintain cover within MARSpace, and eventually, we would have sent another mission to retrieve the probe."

DATA TRANSFER: 25% COMPLETE

ACU -> TIMER : TRUE

READY

>z
Time passes.

Janet glances furtively towards the cargo bay doors, "Someone will hear the gun; you won't be able to walk out of here."

David gives the door an off-handed glance, and replies with assurance, "My dear, the whole facility is secured by order of the mission director, that is to say, me. The probe data are such a sensitive subject that I had no difficulty getting authorization to lock down the entire facility. There's nobody here except us lovebirds."

David leers like a predator at Janet, who recoils in disgust.

DATA TRANSFER: 50% COMPLETE

ACU -> TIMER : TRUE

READY

* * *

>amusing
Congratulations. Of the 187 things you did today, you must have gotten some of them right, because you didn't screw up the entire universe and you're still alive to read about it. Before you get too cocky, however, here are a few hints about stuff you might want to look for the next time you play "Rover's Day Out":

* As the ACU, you experienced four of the seven possible dream sequences . Getting up in the morning and getting things done is all well and fine, but a you can afford to dream a little.

* During personality imprinting, both the ACU and Rover incorporated memories from their real-life counterparts. You tapped into zero out of the twenty-nine engrams resident in the ACU memory banks, and zero out of Rover's thirty-four memories.

* When the Myomita merchant marine ships intercepted you on the way back to Mars, you managed to employ four out of the eight or so methods to eliminate them from the ship. You should be congratulated on finding two out of the about four ways to dislodge an assault ship once it attaches to Valkyrie. Good going.

* Were you able to use any Flosix commands to, for instance, change or list virtual directories, or perform other, more interesting command line wizardry?

* Did Rover perform any of his tricks for you?

* Did Rover succeed in his amorous advances towards his significant other in the park?

* Did you read the texts in the "help" menu?

Would you like to RESTART, RESTORE a saved game, see some suggestions for AMUSING things to do, or QUIT?